Your mother needs you.  The whole village needs you.  You can do this.  You must do this.

The mantra repeats in your head, pushing you on as you wheel in circles over the forest canopy, riding thermals to heights where none but other Falcon Clan members could see you.  And there's no more Falcon Clan in the Royal Aerie--you and the rest of your clan were all banished years ago.  Three days ago, approaching from underneath worked, as none were expecting it.  But while technically successful, you failed to snatch your intended quarry: the Scroll of Health.  The sages had been unable to tell you what color capsa would hold it: you now know that it's not purple, gold, nor red.

By tonight, you will know.  You're not leaving without it.

course correction
An Interactive High Heist by Lucian Smith
Release 1 / Serial number 260227 / Inform 7 v10.1.2
For more information, try ABOUT and CREDITS.

High Above the Royal Aerie
You drift in lazy circles well above the Royal Aerie below, safely above your quarry.  Your acute eyesight lets you see the entire layout, and how it relates to today's air currents, winds, and thermals.  Royal Quarters to the north, well defended by circling Raven clan guards.  The librum to the east.  In the center of the Aerie (and directly below you) is the Great Hall.  Other royal aeries dot the forest in the distance, but this complex holds your quarry.

>credits
This game would not have been possible without the intense energy of @otistdog on the intfiction forums creating the idea of having an "Iron ChIF" competition, nor without Ryan Veeder agreeing to be the aforementioned "Iron ChIF Inform 7" to compete against.

Particular thanks go to my betatesters, Sarah Wilson (day 1), Stephen Granade (day 2), Allyson Gray (day 3), and Dan "inky" Shiovitz (day 4).

Thanks also to the official judges for this competition: Chandler Groover, Victor Gijsbers, J. J. McC, Brian Rushton, and N. Cormier, and technical advisor Zed Lopez.  You all have been great!

The cover art image is courtesy Greg Hume (Greg5030)/CC BY-SA 3.0

Apologies to N. Cormier for letting her cats out backstage.  I forgot to check the spotlights!

* * *

>d
If you get any closer to the aerie without summoning mist first, the guards would surely see you.  It's why, as a Bostrat, you were originally chosen to go on this mission.

>summon mist
Calling on your heritage as a Bostrat, you summon moisture from the air, and it slowly coalesces into a creeping grey mist, obscuring you from sight.  In gentler times, you would be doing this to ensure the growth of the fields and forests; now you must use it to hide from prying eyes that would keep you from your quarry.

You stop at the natural inflection point for clouds given today's weather.  You could make it thicker still, but it would then start to dissapate.

>d
You descend in wide circles, pulling mist down with you in what you hope is a sufficiently unsuspicious manner, trusting your memorization of the air currents to tell you where you're going...

Great Hall Landing Cradle
The Landing Cradle of the Great Hall spreads out over nearly a quarter of the vast building.  During your time here, you learned this was so that when a number of important guests and their retinues arrive at the same time, they can land simultaneously, instead of one after the other, which some would invariably take as meaning "in order of importance".  The huge double doors of the Great Hall are on the west side of the landing cradle, and unguarded.

To the north is the Royal Quarters and Gardens, the Librum to the east, and as always, you can return to the skies or descend to the forest.

>d
You tuck in your wings and dive down into the forest below the Aerie, dodging tightly-spaced trees with acrobatic precision.

In the Forest
The trees below the Royal Aerie grow more closely together than in the rest of the forest, and include a wider variety, so that differently-colored woods could be incorporated into the buildings above.  This makes it harder to navigate down here--or it would if you weren't so amazing at navigation.

Even through the mist, your sharp eyes spot a fine net, stretched between the trees.  It seems to be set to prevent anyone from coming up from the forest below.

>open gold
You open the gold capsa of down, revealing a scroll of rudenj.

Immediately, "down" now means "towards the gold capsa" instead of "towards the earth".  Even being ready for it, it takes you a few flaps to reorient yourself, and you blink away the slight dizziness.  Then you pause.  No sounds from the Aerie.  Apparently, the new "down" is close enough to the old "down" that whatever sensors they have up there didn't detect a change.  Good.

The momentum you had from your dive wears off.  Fun while it lasted!

>drop gold
You let go of the gold capsa of down.  It remains floating in the air, exactly where you left it.  You push it to a slightly less conspicuous location.

>open purple
You open the purple capsa of opening, revealing a scroll of rezrov.

As you open the purple capsa, an almost-palpable wave of force emanates from it, as the power of the revealed scroll of rezrov is released.

The magic of the red capsa of hasten prevents it from being opened.
The straps and buckles on your rucksack fly open and it falls!
Fortunately, it hovers in midair due to the scroll of down, so you're able to immediately grab it again.

From... well, from everywhere in the Aerie, it seems, Woodpeckers start drumming out messages in their Pounding dialect:  "Intruder! Estimated direction is..." and then each one individually seems to be telegraphing the direction from them to you.  You can't discern any one drummer from any other drummer, but you can at least tell that each seems to be drumming on sheets of metal that differ from each other, as the frequencies are all different from each other.  That makes the information somewhat useless to you, because you've not been trained to distinguish Pounding at different frequencies.  And because you already know where you are.  Sadly, the Raven Guards are indeed trained to distinguish Pounding frequencies.

And if they didn't know where you were, they do now.

* * *

>showme cloak
(the purple hunting cloak)
purple hunting cloak - thing
location: on the two cloak posts in the Void
unlit, inedible, portable, wearable; singular-named, improper-named; purple
description: "A plaque by the cloaks claims that in prehistoric times, people made these cloaks out of hippotomai skins to mask their scent.  The dark purple variegation also helped with camoflage.  You couldn't fly with them on, but some prey had gotten extremely adept and spotting flying enemies, so hunters took to sneaking up on foot."
initial appearance: none
printed name: "purple hunting cloak"
printed plural name: none
indefinite article: none
list grouping key: none

* * *

>showme me
yourself - woman
    leather rucksack (worn) - player's holdall
        purple capsa of opening - capsa
            scroll of rezrov - scroll
        gold capsa of down - capsa
            scroll of rudenj - scroll
        red capsa of hasten - capsa
            scroll of quiste - scroll
location: in High Above the Royal Aerie
unlit, inedible, portable; transparent, female; singular-named, proper-named; description: "As a member of the Falcon Clan, your most striking features are your large black eyes, offset with yellow, and slightly recessed under a grey-feathered scalp.  The grey blends from your head, mottling along your back and the backside of your wings, while your front, throat, and underwings are feathered white with brown striations.  A close encounter with a Raven during your previous mission left a few missing contour feathers and some down, but not enough to hinder movement or flight."
initial appearance: "Constance, a powerful Falcon Clan female, is here, her large black eyes watching you with fierce intensity."
carrying capacity: 100
printed name: "Constance"
printed plural name: "women"
indefinite article: none
list grouping key: none
Constance condition: cruising

>summon mist
Calling on your heritage as a Bostrat, you summon moisture from the air, and it slowly coalesces into a creeping grey mist, obscuring you from sight.  In gentler times, you would be doing this to ensure the growth of the fields and forests; now you must use it to hide from prying eyes that would keep you from your quarry.

You stop at the natural inflection point for clouds given today's weather.  You could make it thicker still, but it would then start to dissapate.

* * *

>n
You gracefully flit between the trees back up north above the canopy.

Royal Gardens
The royal gardens is the most lavishly opulent and sensuous entrance to any aerie you've seen in your life.  Trees, vines, and flowers of every variety spring up from everywhere, each seemingly placed in it only appropriate spot.  The landing cradle next to the garden door to the Royal Quarters themselves is nestled between gracious arcs of poplar trunks, each bedecked with shaded and inviting roosts.  Which, as you know from your childhood days swooping and laughing through these gardens, invariably contain at least eight guards.

From here, you can return to the skies or descend to the forest.  The Great Hall is to the south, and the Librum to the southeast.

The momentum you had from your dive wears off.  Fun while it lasted!

>open purple
You open the purple capsa of opening, revealing a scroll of rezrov.

As you open the purple capsa, an almost-palpable wave of force emanates from it, as the power of the revealed scroll of rezrov is released.

Garden door clicks as it unlocks!
The magic of the gold capsa of down prevents it from being opened.
The magic of the red capsa of hasten prevents it from being opened.
Garden door flies open!
The straps and buckles on your rucksack fly open and it falls!

Dropped.

From... well, from everywhere in the Aerie, it seems, Woodpeckers start drumming out messages in their Pounding dialect:  "Intruder! Estimated direction is..." and then each one individually seems to be telegraphing the direction from them to you.  You can't discern any one drummer from any other drummer, but you can at least tell that each seems to be drumming on sheets of metal that differ from each other, as the frequencies are all different from each other.  That makes the information somewhat useless to you, because you've not been trained to distinguish Pounding at different frequencies.  And because you already know where you are.  Sadly, the Raven Guards are indeed trained to distinguish Pounding frequencies.

And if they didn't know where you were, they do now.

>u
High Above the Royal Aerie
Your summoned mist both obscures you and blocks you from seeing the Royal Aerie.  But you've already memorized its layout, and how it relates to today's air currents, winds, and thermals.  Royal Quarters to the north, well defended by circling Raven clan guards.  The librum to the east.  In the center of the Aerie (and directly below you) is the Great Hall.  Other royal aeries dot the forest in the distance, but this complex holds your quarry.

You've barely left Royal Gardens when a squad of Raven Guards wheels in from behind, hot on your tail!

>d
You tuck in your wings and dive down  towards the Aerie, thrilling to the misty wind streaming through your feathers.

Great Hall Landing Cradle
The Landing Cradle of the Great Hall spreads out over nearly a quarter of the vast building.  During your time here, you learned this was so that when a number of important guests and their retinues arrive at the same time, they can land simultaneously, instead of one after the other, which some would invariably take as meaning "in order of importance".  The huge double doors of the Great Hall are on the west side of the landing cradle, and unguarded.

To the north is the Royal Quarters and Gardens, the Librum to the east, and as always, you can return to the skies or descend to the forest.

Your speed puts more distance between you and your pursuers, but it's not quite fast enough, or the mist isn't thick enough, or both, and your pursuers manage to keep you in sight.

>d
In the Forest
The trees below the Royal Aerie grow more closely together than in the rest of the forest, and include a wider variety, so that differently-colored woods could be incorporated into the buildings above.  This makes it harder to navigate down here--or it would if you weren't so amazing at navigation.

Even through the mist, your sharp eyes spot a fine net, stretched between the trees.  It seems to be set to prevent anyone from coming up from the forest below.

You expertly twist at breakneck speeds, weaving through three Ash trunks, over a branch, and around and behind a Redwood, where you halt, twist, and dive straight down the trunk, out of view of any stray Raven.

The Raven's frustrated caws echo in the mist.  In time, the woodpeckers cease their drumming, and the cawing fades as well.  Protocol would dictate that they return to guarding priority items.  If there were any reserves left, they would be called up, but the Red Plague has affected the Raven Guard as sorely as your own community.

You retrieve your rucksack and any fallen capsae, and plot a now-unseen course back to the familiar currents above the Aerie to ponder your next move.

                                                             *    *    *

You wait, expectantly.

Silently, your cell door unlocks, then swings open.

Well above your cell, you sense rezrov, rudenj, and quiste settle in their movements until they make lazy circles, high above the Aerie. Igram and taclor remain in place, quiet.

It is time.

Forgotten Brig
A small but cosy cell, grown with austerity but basic comfort in mind.  Your now-open cell door leads west.

>w
Disused Hallway
The only time you ever saw anyone in this hallway was when Georg came to give you your meals, or clean the cell.  The living walls, still elegantly patterned, even here, self-replenish, and the floor carries away shed bark through the grate.  It leads west into the living area, and your old cell door leads east.

>in
You flatten yourself to the floor and, hearing your bones creak, roll into the space behind the grate.  Using your minimal throck ability, you whisper to the veins of this place: "I am extra.  I am not needed.  Take me from this place, which will renew itself through my absence."

After a few moments, you feel an undulation in the slick rippled floor beneath you, and you are compressed even further, as its peristalsis slides you slowly, and then more rapidly, away from your only home for the last ten years.  Then with a sudden >plop<, you're ejected into space.

You try to spread your wings, but your reaction time is not what it was, and you hit wirey netting before fully stopping yourself.

No matter.

In the Forest
The trees below the Royal Aerie grow more closely together than in the rest of the forest, and include a wider variety, so that differently-colored woods could be incorporated into the buildings above.  This makes it harder to navigate down here--or it would if you weren't so amazing at navigation.

Even through the mist, your sharp eyes spot a fine net, stretched between the trees.  It seems to be set to prevent anyone from coming up from the forest below.

>n
You gracefully flit between the trees back up north above the canopy.

Royal Gardens
The royal gardens is the most lavishly opulent and sensuous entrance to any aerie you've seen in your life.  Trees, vines, and flowers of every variety spring up from everywhere, each seemingly placed in it only appropriate spot.  The landing cradle next to the garden door to the Royal Quarters themselves is nestled between gracious arcs of poplar trunks, each bedecked with shaded and inviting roosts.  Which, as you know from your childhood days swooping and laughing through these gardens, invariably contain at least eight guards.

From here, you can return to the skies or descend to the forest.  The Great Hall is to the south, and the Librum to the southeast.

>n
From here, you can fly south to the Great Hall, or southeast to the Librum. The net prevents you from reaching the forest floor from here, but you can go straight up to the Great Hall, east (and up) to the Librum, or north (and up) to the Royal Quarters and Gardens.

>u
High Above the Royal Aerie
Your summoned mist both obscures you and blocks you from seeing the Royal Aerie.  But you've already memorized its layout, and how it relates to today's air currents, winds, and thermals.  Royal Quarters to the north, well defended by circling Raven clan guards.  The librum to the east.  In the center of the Aerie (and directly below you) is the Great Hall.  Other royal aeries dot the forest in the distance, but this complex holds your quarry.

Constance, a powerful Falcon Clan female, is here, her large black eyes watching you with fierce intensity.

                                                             *    *    *

"Good job, Constance," you say as you approach to fly adjacent to her broad circling.

She peers at you, and you know she can make out every barb on each of your feathers.  Patiently, you wait.

"You're Horatio," she finally says.  "Didn't the queen... imprison you for heresy?"

"Indeed," you reply.

"And I just unlocked your cell," she says.

"Indeed," you reply.

"They wouldn't tell me what the heresy was.  I guess that's the point of trying to suppress dangerous ideas."

This time, you just wait, and slightly incline your head.  Saying "Indeed" again might make her self-conscious about her babbling.

There's a pause.

"What was it?" she asks.

1) Tell her about capsae.
2) Tell her what you can do.
3) OK, I'm a tester and I need to skip ahead and be Constance, fiddling with scrolls and stuff.
4) I'm also a tester, and I just want to go back to the beginning of this conversation.

>1
[Tell her about capsae.]

"I believe that the gods gave us the capsae to benefit everyone," you say.

Constance frowns.  "That's not... a dangerous idea.  I mean, people may not truly believe in the gods much today, but they're generally seen as having been... nice?  I guess?"

1) Explain.
2) OK, I'm a tester and I need to skip ahead and be Constance, fiddling with scrolls and stuff.
3) I'm also a tester, and I just want to go back to the beginning of this conversation.

>1
[Explain.]

"When I say everyone, I mean everyone.  In the whole world.  As far as the Clans extend."

Constance chuckles.  "A little hard for the capsae to do that.  Longest range I know of is, like, two miles."

"Indeed," you reply.

Constance locks her wings so she can turn and look at you intently for several seconds as she glides.  She probably thinks she's being tested.  Which would be good, because she is.  You wait.

"So.  You believe that the capsae are being misused.  That the kingdoms hoarding them should instead... share them?  Move them around?  Shuffle them, so each kingdom gets a bit of their power every so often?"

"Misused, yes," you reply.  "And, yes, it would be in the spirit of that initial gift to share them more.  But what I proposed to your queen, and to other queens and kings of other realms, goes beyond this."

Constance thinks for a bit.  Then she rolls her eyes.  "OK, yeah, I have no idea what you're talking about."

1) Ask her about scrolls.
2) Tell her about scrolls.
3) OK, I'm a tester and I need to skip ahead and be Constance, fiddling with scrolls and stuff.
4) I'm also a tester, and I just want to go back to the beginning of this conversation.

>1
[Ask her about scrolls.]

"What do you do with scrolls?" you ask.

Constance scoffs.  "Read them!" she exclaims, then laughs, as another thought occurs to her. "Which is the one thing you can't do with the scrolls in the capsae, because nobody knows..."  She trails off, and gives you another look.  "Wait, really?  You?"

1) Tell her what you can do.
2) OK, I'm a tester and I need to skip ahead and be Constance, fiddling with scrolls and stuff.
3) I'm also a tester, and I just want to go back to the beginning of this conversation.

>1
[Tell her what you can do.]

"You've seen the scrolls themselves?  The writing on them?"

"'Indeed,'" Constance replies, raising an eyebrow.  You grin.

"What you may not know is that those symbols are not found in any other form of known writing.  There are fragments of writing from before the capsae.  They differ.  Some say it is the language of the gods themselves."

"Woo, fancy," says Constance.  "In other words, they're gibberish."

"No," you reply.  "I can read them."

"Oh?  What do they say?" Constance asks.

1) Tell her the truth.
2) Wax poetical a bit.
3) OK, I'm a tester and I need to skip ahead and be Constance, fiddling with scrolls and stuff.
4) I'm also a tester, and I just want to go back to the beginning of this conversation.

>1
[Tell her the truth.]

"I don't know," you tell her.

Constance sputters.  "But you--" she begins, then cuts herself off, looking at you askance again.  She's a clever woman.  You wait, tipping your wings synchronously with hers as you turn into another circuit.

"So.  You learned the language from somewhere."  She thinks.  You wait.  "No, you said the symbols matched no other writing.  You were born knowing the language.  It's your heritage, as I was born knowing how to summon mist."

You let her think, the lack of any contradiction from you enough of an encouragement.

"Which means you've either just never seen an actual scroll--which seems unlikely; the queen didn't get mad at you until several days had passed--or," she slows down, but continues, "or you were born with the ability to read, but not understand."

"Inde--"  Constance shoots you warning look.  "Yes.  That's it exactly.  Congratulations."  You bob your head and splay your wingfeathers in a grin of approval.

"So, you want to read a capsa's scroll.  And you won't know what you're reading." says Constance.

1) Tell her about capsae.
2) Share your speculation.
3) OK, I'm a tester and I need to skip ahead and be Constance, fiddling with scrolls and stuff.
4) I'm also a tester, and I just want to go back to the beginning of this conversation.

>1
[Tell her about capsae.]

"I believe that the gods gave us the capsae to benefit everyone," you say.

Constance frowns.  "That's not... a dangerous idea.  I mean, people may not truly believe in the gods much today, but they're generally seen as having been... nice?  I guess?"

1) Explain.
2) OK, I'm a tester and I need to skip ahead and be Constance, fiddling with scrolls and stuff.
3) I'm also a tester, and I just want to go back to the beginning of this conversation.

>1
[Explain.]

"When I say everyone, I mean everyone.  In the whole world.  As far as the Clans extend."

Constance chuckles.  "A little hard for the capsae to do that.  Longest range I know of is, like, two miles."

"Indeed," you reply.

Constance locks her wings so she can turn and look at you intently for several seconds as she glides.  She probably thinks she's being tested.  Which would be good, because she is.  You wait.

"So.  You believe that the capsae are being misused.  That the kingdoms hoarding them should instead... share them?  Move them around?  Shuffle them, so each kingdom gets a bit of their power every so often?"

"Misused, yes," you reply.  "And, yes, it would be in the spirit of that initial gift to share them more.  But what I proposed to your queen, and to other queens and kings of other realms, goes beyond this."

Constance thinks for a bit.  Then her eyes widen.  "You want to read the scrolls!" she exclaims.

1) Share your speculation.
2) OK, I'm a tester and I need to skip ahead and be Constance, fiddling with scrolls and stuff.
3) I'm also a tester, and I just want to go back to the beginning of this conversation.

>1
[Share your speculation.]

"I will not know what it is I'm saying, but I have a guess about what will happen.

And no capsae holder I have yet met will risk such a thing," you say.

1) {Switching to Constance}: Scoff at "capsae holder".
2) {Switching to Constance}: Ask about his guess.
3) OK, I'm a tester and I need to skip ahead and be Constance, fiddling with scrolls and stuff.
4) I'm also a tester, and I just want to go back to the beginning of this conversation.

>1
[{Switching to Constance}: Scoff at "capsae holder".]

You scoff.  "No Queen or King, you mean."

"You personally currently hold three capsae, more than some kingdoms," replies Horatio,

You laugh.  "'Cause I stole 'em!  And they weren't even the one I wanted; I just didn't know what color I was after!"

"Nevertheless," you tell her, "you are their holder. If you told me you wanted me to read one, I then could.

1) He needs instructions?
2) Ask about his guess.
3) OK, I'm a tester and I need to skip ahead and be Constance, fiddling with scrolls and stuff.
4) I'm also a tester, and I just want to go back to the beginning of this conversation.

>1
[He needs instructions?]

"Wait.  So, I could order you to read a capsa?  And the magic would compel you to do it?" you ask, incredulously.

"No.  I will not read one without the holder's permission, but I may refuse any order," Horatio replies.

"'Will not.'  So you're not compelled to do anything.  It's just a personal choice," you say.

Horatio winces slightly.  "I suppose, technically, you are correct.  It is a tradition among the Readers who know the history."

1) Getting information out of this guy is like pulling mist out of the desert.  Say nothing.
2) OK, I'm a tester and I need to skip ahead and be Constance, fiddling with scrolls and stuff.
3) I'm also a tester, and I just want to go back to the beginning of this conversation.

>1
[Getting information out of this guy is like pulling mist out of the desert.  Say nothing.]

You say nothing, and wait expectantly.

In response, Horatio offers you the blue capsa he's holding.  It's closed, and you cock your head questioningly at him.  "It safe.  Nothing will happen when you open it."

Weird trap if it was a trap.  Fine.  You open the blue capsa, bracing yourself... and nothing happens.  You look at the scroll, which seems to have no symbols on it at all apart from the title:  "BOSTRAT".

1) Is that real?
2) Wow.
3) OK, I'm a tester and I need to skip ahead and be Constance, fiddling with scrolls and stuff.
4) I'm also a tester, and I just want to go back to the beginning of this conversation.

>1
[Is that real?]

Horatio shrugs.  "I cannot prove it is so.  Many have chosen not to believe.  But I can sense capsae, and I can sense this."

1) Wow.
2) OK, I'm a tester and I need to skip ahead and be Constance, fiddling with scrolls and stuff.
3) I'm also a tester, and I just want to go back to the beginning of this conversation.

>1
[Wow.]

"Wow," you say, amazed by the implication.

"Indeed," Horatio replies.  "At one time, if my research and the ancient tales I have collected are correct, this capsa, when activated, would bring rain to the land around it."

"And now... any Bostrat anywhere in the world can bring rain," you conclude.  "If they work together," you amend.

Horatio nods, seriously.  "In the past, this scroll could alter its surroundings.  When it was finally read, it changed the world.

You gaze in wonder at the capsa.  Your heritage.  You can't say for sure it's genuine any more than Horatio can, but you feel the stirrings of some sort of pull towards it.

1) Ask about the other abilities.
2) Pull everything together.
3) OK, I'm a tester and I need to skip ahead and be Constance, fiddling with scrolls and stuff.
4) I'm also a tester, and I just want to go back to the beginning of this conversation.

>1
[Ask about the other abilities.]

"And the Throckwrights?  The Ikniq?" you ask.

Horatio nods.  "From the stories I have collected, I believe "throck" was the first of the scrolls to be read out and gifted to the people, and a renaissance of agriculture and architecture resulted.  When civilization pushed into the barren boundaries of the known world, bostrat was next, and spread our people across the desert."

He stops.  There's an obvious Part Three, but you'll be damned if he makes you ask for it.  You wait.  You make another complete circuit together, and you realize there's a tear in his eye.  You're suddenly glad you gave him space to be emotionally ready to finish the story, though you're worried you already know where this is going.

Finally, with a deep breath, he speaks.  "Yes.  The first two gifts benefitted the herbivore clans more than the carnivore clans, or so they claimed.  Ikniq was next chosen, and hunting did indeed become easier."  He pauses.

"But so did hunting each other," you conclude, quietly.  Horatio nods.  The Great Wars.  Entire clans wiped out.  Whole swaths of countryside burned to the rock, where still nothing grows, a thousand years later.

1) Pull everything together.
2) OK, I'm a tester and I need to skip ahead and be Constance, fiddling with scrolls and stuff.
3) I'm also a tester, and I just want to go back to the beginning of this conversation.

>1
[Pull everything together.]

"So that's your heresy," you conclude.  "You want to read a capsa's scroll.  And change the world again."

"Not just any capsa.  The scroll of health.  Taclor.  Ten years ago, I would have been happy to read any.  Now, it must be that one.  But I will not make that choice on my own.  Every Reader like myself has the innate ability to Read a single scroll, and I will yield to the will of its holder, as my predecessors swore to do in the aftermath of the Great War.  But I will not waste my ability on anything else."

1) He can't have the scroll.
2) You need more details.
3) OK, I'm a tester and I need to skip ahead and be Constance, fiddling with scrolls and stuff.
4) I'm also a tester, and I just want to go back to the beginning of this conversation.

>2
[You need more details.]

"So, what will happen?  What would it do if it was read?" you ask.

"I cannot say.  The gods created the scrolls with their local effects, I believe, to give people a taste of what was to come.  Throck, as a capsa, encouraged vegetation to grow.  Throckwrights push vegetation to grow in very specific ways.  Bostra, as a capsa, caused rain by itself, but the bostra must work together to do the same.  Ikniq... I can find no record of what it did as a capsa.  That information must have been purged."  He pauses.  You let him collect his thoughts.

"My best guess is that it will give people the ability to heal themselves; perhaps even to regenerate.  Maybe it will make them immune to disease.  Maybe to death.  The gods only know."

1) He can't have the scroll.
2) Figure out what's next.
3) OK, I'm a tester and I need to skip ahead and be Constance, fiddling with scrolls and stuff.
4) I'm also a tester, and I just want to go back to the beginning of this conversation.

>1
[He can't have the scroll.]

"You can't read that scroll," you say.  "I need it to save my mother.  To save the village."

"The whole world," Horatio turns his head to face to you, "could say the same."

"But I'm here!" you shout.  "I have three capsae.  I didn't start any wars!  I didn't force people to live with their livestock and kickstart the Red Plague!  The Queen's hoarding the capsa for gods-know-what reason, probably so the selfish bastard could ensure she doesn't come down with it herself..."

Horatio flinches.  That's right, he knew you when you and the now-Queen were... closer.  Inseparable.

"I'll take it around the world!" you declare.  "I'll take it to every village in this kingdom; wherever the need is greatest.  I'll take it to other kingdoms!"

Horatio nods.  "When you are the holder, you may do as you wish," he says, simply.  "But first, you must become the holder.  And for that, you will need igram.  It's in the librum.

1) Figure out what's next.
2) OK, I'm a tester and I need to skip ahead and be Constance, fiddling with scrolls and stuff.
3) I'm also a tester, and I just want to go back to the beginning of this conversation.

>1
[Figure out what's next.]

"So, what do we do next?" you ask.

"I can sense the capsae.  Taclor, health, is in the Royal Quarters.  Igram is in the Librum."

"I ransacked the Librum last time; there was only these three," you protest.

"It was considered worthless, and was discarded.  With it, I can lead you to taclor," Horatio tells you.

"What does it--you know, never mind, you obviously don't want to tell me.  How do I get it?" you ask.

"It is in the Librum," he says, simply.  "Therefore, either you must go into the Librum, or the capsa must come out.  I will talk to the guard to distract her, if that helps," Horatio offers.

Gods, yes, you can inflict this man on someone you hate.  "Perfect," you say, grimly. You shake yourself, and turn to your new task.

High Above the Royal Aerie
Your summoned mist both obscures you and blocks you from seeing the Royal Aerie.  But you've already memorized its layout, and how it relates to today's air currents, winds, and thermals.  Royal Quarters to the north, well defended by circling Raven clan guards.  The librum to the east.  In the center of the Aerie (and directly below you) is the Great Hall.  Other royal aeries dot the forest in the distance, but this complex holds your quarry.

Horatio is here, watching you with quiet aplomb and patience.

With a solemn nod to you, Horatio explains where the black capsa of igram should be, then banks to the east, and descends to the Librum.

>d
You tuck in your wings and dive down  towards the Aerie, thrilling to the misty wind streaming through your feathers.

Great Hall Landing Cradle
The Landing Cradle of the Great Hall spreads out over nearly a quarter of the vast building.  During your time here, you learned this was so that when a number of important guests and their retinues arrive at the same time, they can land simultaneously, instead of one after the other, which some would invariably take as meaning "in order of importance".  The huge double doors of the Great Hall are on the west side of the landing cradle, and unguarded.

To the north is the Royal Quarters and Gardens, the Librum to the east, and as always, you can return to the skies or descend to the forest.

>u
High Above the Royal Aerie
Your summoned mist both obscures you and blocks you from seeing the Royal Aerie.  But you've already memorized its layout, and how it relates to today's air currents, winds, and thermals.  Royal Quarters to the north, well defended by circling Raven clan guards.  The librum to the east.  In the center of the Aerie (and directly below you) is the Great Hall.  Other royal aeries dot the forest in the distance, but this complex holds your quarry.

The momentum you had from your dive wears off.  Fun while it lasted!

>e
You tuck in your wings and dive down east towards the Aerie, thrilling to the misty wind streaming through your feathers.

Librum Landing Cradle
The Landing Cradle of the Librum is beautifully set with interlocking redwood and pine, suggesting shelves of books.  The Librum Door leads inward to the Librum itself.

To the west is the Great Hall, and to the northwest is the Royal Quarters and Gardens.  You can also re-ascend to the skies or descend to the forest below.

Horatio is talking slowly to the lone guard about the ethics of a monarchy, driving the guard quietly insane.

In the cradle next to the guard is a small pile of tiny padlocks, each open.

>in
Using the extra speed from your dive, you quietly plunge through the Librum door behind the distracted guard, pulling up sharply on the other side before crashing into anything.

Librum
The librum contains two levels of scrolls and books, with easy access to all of the curving shelves, and plenty of reading roosts with natural and artificial lighting.  You know from your childhood where the best roosts are, and what sections contain the most exciting stories.  In the center of the lower room is a lavish display case, now hastily boarded over, which three days ago held the purple, gold, and red capsae.  The Librum Door is back up at the top level.

In the back of the lower level, in a storage cupboard, you find the black capsa, just as Horatio described to you.  You wonder how he managed to find out where it was, but suppose the man has his conversational tricks.

The momentum you had from your dive wears off.  Fun while it lasted!

>get black
(the black capsa)
Taken.

>out
Listening to Horatio talk with the guard, you enter the shadows just inside the Librum door, where you can watch the guard but not be seen.  When the moment is right, you launch yourself through, and back up into the safety of the mist.

Librum Landing Cradle
The Landing Cradle of the Librum is beautifully set with interlocking redwood and pine, suggesting shelves of books.  The Librum Door leads inward to the Librum itself.

To the west is the Great Hall, and to the northwest is the Royal Quarters and Gardens.  You can also re-ascend to the skies or descend to the forest below.

Horatio is talking slowly to the lone guard about his grandchildren, driving the guard quietly insane.

In the cradle next to the guard is a small pile of tiny padlocks, each open.

>w
Great Hall Landing Cradle
The Landing Cradle of the Great Hall spreads out over nearly a quarter of the vast building.  During your time here, you learned this was so that when a number of important guests and their retinues arrive at the same time, they can land simultaneously, instead of one after the other, which some would invariably take as meaning "in order of importance".  The huge double doors of the Great Hall are on the west side of the landing cradle, and unguarded.

To the north is the Royal Quarters and Gardens, the Librum to the east, and as always, you can return to the skies or descend to the forest.

Horatio glides out of the mist and circles near you.  He nods at the black capsa.  "Excellent work.  Now, we need something from the Great Hall."

Horatio glides through the open double doors of the Great Hall.

>w
Upper Great Hall
There is a small platform just inside the huge double doors of the Great Hall, and that's it.  The platform is lined with a single elegant grown-mahogany branch that wraps around the whole platform.  It varies in size and thickness, so that all types of feet fit somewhere along it, so people can comfortably launch themselves into the air to glide down to the floor level, or grab it for stability as they return.

>d
You step on to your favorite spot on the mahogany branch, and launch yourself downward in a graceful glide.

Lower Great Hall
When not prepared for a particular occasion, like now, the floor of the Great Hall is cleared of everything extraneous.  The exposed floor is absolutely exquisite, with swooping lines interspersed with starbursts, all in multicolored woods of all hues.  What doesn't change about the Great Hall floor is the display nooks along the sides: at least twenty nooks containing all manner of artifacts from around the world.

Horatio is here, watching you with quiet aplomb and patience.

You circle down and land near Horatio.  "So.  Now will you tell me what igram does and why it's so important?" you ask.

"It is better to show you," he replies.  "Try it."

You sigh.  Fine.

>open black
(the black capsa)
You open the black capsa, revealing a scroll of igram.

For a moment, the purple capsa seems to flicker.  But you look again, and nothing seems to have changed.
Suddenly, two hunting cloaks in a display of ancient pre-historical artifacts disappear!

>x cloaks
The cloak posts appear to be empty.

>touch posts
You reach out and pick up the cloak.  It seems none the worse for wear from having been invisible.  Next to you, Horatio picks up the other.

You turn to Horatio, questions bubbling in your head.  "So, nothing else here turned invisible.  Does the scroll work on cloaks?  Things for hunting?  Ancient materials?  Hides?"

Horatio looks a little uncomfortable.  "No.  It works on... purple."

"Purple?!?" you exclaim/ask.

"Purple," he confirms.

"It turns purple things invisible?  Purple things!  The gift from the gods, on a scroll written in their secret language!  To turn purple things invisible!"  You cackle in glee.

Horatio looks uncomfortably affronted.  "The hippotomai were common in those days.  It made sense..."

You continue to laugh, cutting him off, but unable to contain your utter delight.  "Herds of invisible hippotomai!  Grass on the marshy banks disappearing into nowhere!  Weird divots in the lakes!  I bet--wait!  The trickster god!  Ape, the trickster!  Stohleblanc!"  You laughter gets more hysterical and you nearly can't breathe.

With as much dignity as he can muster, Horatio waits solemnly for you to finish laughing.  You fail to do so.  Finally he gets impatient and turns to go.  "We can enter the Royal Quarters cloaked.  I will follow you."

"Wait," you sputter, trying to push down the hysteria.  "How will you follow me?  I'll be invisible!"

"I can sense the capsae.  I will know where you are," he replies, and with a deep breath, he gathers himself and flies up and out of the Great Hall.

>u
Upper Great Hall
There is a small platform just inside the huge double doors of the Great Hall, and that's it.  The platform is lined with a single elegant grown-mahogany branch that wraps around the whole platform.  It varies in size and thickness, so that all types of feet fit somewhere along it, so people can comfortably launch themselves into the air to glide down to the floor level, or grab it for stability as they return.

>w
From here you can go down, or back out to the west.

>e
Great Hall Landing Cradle
The Landing Cradle of the Great Hall spreads out over nearly a quarter of the vast building.  During your time here, you learned this was so that when a number of important guests and their retinues arrive at the same time, they can land simultaneously, instead of one after the other, which some would invariably take as meaning "in order of importance".  The huge double doors of the Great Hall are on the west side of the landing cradle, and unguarded.

To the north is the Royal Quarters and Gardens, the Librum to the east, and as always, you can return to the skies or descend to the forest.

>n
Royal Gardens
The royal gardens is the most lavishly opulent and sensuous entrance to any aerie you've seen in your life.  Trees, vines, and flowers of every variety spring up from everywhere, each seemingly placed in it only appropriate spot.  The landing cradle next to the garden door to the Royal Quarters themselves is nestled between gracious arcs of poplar trunks, each bedecked with shaded and inviting roosts.  Which, as you know from your childhood days swooping and laughing through these gardens, invariably contain at least eight guards.

From here, you can return to the skies or descend to the forest.  The Great Hall is to the south, and the Librum to the southeast.

>in
No way.  It wouldn't matter how fast you were, how thick the mist was, anything.  You just can't get in there without being spotted.

>wear cloak
You put on the invisible hunting cloak.

>in
OK.  Walking.  Right.  You raise yourself up on the tips of your talons, feeling ridiculous, but not wanting to flatten the grass with your (shudder) footsteps and give yourself away.  You wait for one of the guards to pass, then carefully take cautious steps towards the door.  Nobody reacts.  Hardly daring to breathe, you proceed further, antsy and ready to take to the skies any second.  Which wouldn't work, because you have this damn cloak on.  Whatever.  Two more steps.  You reach the door.  You hop (shudder) across the lintel.

You're in.

A few more steps, and a voice behind you says "We should take the second hallway." You nearly yelp, but stop yourself.  You knew Horatio would be here.  You were expecting him.  Right.

You take a deep breath.  "Lead on," you whisper.

"I can't; I'm invisible.  I will tell you where to go, and follow you," he replies.  Right.

                                                             *    *    *

You make your way, with Horatio's direction, through the Royal Quarters.  A time or two Horatio leads you to a place you'd have to fly to get past, but you know this place well, and even though you never walked anywhere, you still know the walking ways.  There's fewer guards to avoid than you expected, meaning that the Queen either has them all outside guarding the entrance, or she just doesn't have them to spare.

As you get closer to your objective, a growing sense of unease forms in the pit of your stomach.  One by one, you pass all the places you pegged as most likely for it to be: the throne room, the vault, even storerooms.

Then:  "This is it," says Horatio.

Oh no.

>s
Nursery Door
You're standing in a hallway, just south of the nursery door, to the west.  The door is open.  All the doors have been open.  You can't see inside yet.  Your heart pounds in your chest.

Horatio is here, watching you with quiet aplomb and patience.

>w
"Horatio," you whisper.  You feel a tap on your shoulder in response.  "I can't go in there wearing this cloak.  I just can't."

A pause.

"Then take it off," he replies.

>take off cloak
Next to you, Horatio takes his own cloak off as well.

You take off the invisible hunting cloak.

>w
Nursery
The Nursery is not exactly how you remember it.  It was set up to grow new walls and furniture over time, to keep any occupant engaged and growing.  But the rhythm of it is baked into your bones.  The place for the roosts, along the north wall.  The desk, grown to the size of the user.  The endless parade of ropes and balls and other toys along the south, some grown and some brought in.  The giant window to the west, overlooking the beautiful, beautiful forest.

On the desk is a green capsa (in which is a scroll of taclor).

Ash doesn't look particularly healthy, but they're in high spirits.

Perched on the open window looking out over the forest is a fledgling Red Wing Clan.  As you enter, they turn and their face and feathers light up with delight.  "Aunty Constance!" they chirrup, and dash across the room to bury their face in your downfeathers.

You stroke the feathers on their head gently.  The feathers crackle worryingly.  "Hi, Ash," you say.  It's good to see you, too."

Their face sufficiently smothered, Ash pops out again excitedly.  "It's been so long!  Did you know there's a whole new wing of the southwest aerie?  Momma took me there just the other day, and..."

Ash prattles happily, telling you about how they're putting in a huge room just for sick people.

>l
Nursery
The Nursery is not exactly how you remember it.  It was set up to grow new walls and furniture over time, to keep any occupant engaged and growing.  But the rhythm of it is baked into your bones.  The place for the roosts, along the north wall.  The desk, grown to the size of the user.  The endless parade of ropes and balls and other toys along the south, some grown and some brought in.  The giant window to the west, overlooking the beautiful, beautiful forest.

On the desk is a green capsa (in which is a scroll of taclor).

Ash doesn't look particularly healthy, but they're in high spirits.

Ash prattles happily, telling you about meeting a Throckwright, and getting to see his pouch of seeds.

>eat ash
What is it about children that makes them seem so delicious?  You playfully peck at Ash's head, and they squeal in delight.

Ash prattles happily, telling you about a model treehouse they made out of sticks.

>take ash
You could take Ash with you.  When you go.  Maybe.

Ash prattles happily, telling you a long convoluted story about drama between their stuffed animals.

* * *

>summon mist
Calling on your heritage as a Bostrat, you summon moisture from the air, and it slowly coalesces into a creeping grey mist, obscuring you from sight.  In gentler times, you would be doing this to ensure the growth of the fields and forests; now you must use it to hide from prying eyes that would keep you from your quarry.

You stop at the natural inflection point for clouds given today's weather.  You could make it thicker still, but it would then start to dissapate.

* * *

I beg your pardon?

>d
You tuck in your wings and dive down into the forest below the Aerie, dodging tightly-spaced trees with acrobatic precision.

In the Forest
The trees below the Royal Aerie grow more closely together than in the rest of the forest, and include a wider variety, so that differently-colored woods could be incorporated into the buildings above.  This makes it harder to navigate down here--or it would if you weren't so amazing at navigation.

Even through the mist, your sharp eyes spot a fine net, stretched between the trees.  It seems to be set to prevent anyone from coming up from the forest below.

* * *

>d
You tuck in your wings and dive down into the forest below the Aerie, dodging tightly-spaced trees with acrobatic precision.

In the Forest
The trees below the Royal Aerie grow more closely together than in the rest of the forest, and include a wider variety, so that differently-colored woods could be incorporated into the buildings above.  This makes it harder to navigate down here--or it would if you weren't so amazing at navigation.

Even through the mist, your sharp eyes spot a fine net, stretched between the trees.  It seems to be set to prevent anyone from coming up from the forest below.

>e
You gracefully flit between the trees back up east above the canopy.

Librum Landing Cradle
The Landing Cradle of the Librum is beautifully set with interlocking redwood and pine, suggesting shelves of books.  The Librum Door leads inward to the Librum itself.

To the west is the Great Hall, and to the northwest is the Royal Quarters and Gardens.  You can also re-ascend to the skies or descend to the forest below.

A lone Raven guard stands in front of the door, dark eyes shifting as she watches the mist.

The momentum you had from your dive wears off.  Fun while it lasted!

>scenes
Scene 'Entire Game' playing (for 6 mins now)
Scene 'Starting Off' ended
Scene 'Momentum' ended
(Scene monitoring now switched on. Type "scenes off" to switch it off again.)

>open purple
You open the purple capsa of opening, revealing a scroll of rezrov.

[Scene 'Everything Is Open' begins]
As you open the purple capsa, an almost-palpable wave of force emanates from it, as the power of the revealed scroll of rezrov is released.

As the shockwave of magic reaches the guard, the padlock on her uniform closest to you pops open.  Then in succession, all the other padlocks she's wearing pop open as well, in perfect concentric circles in order of how distant they are from the scroll.  As her eyes lock with yours, you realize, somewhat belatedly, that you've given her the ability to triangulate on your position.  Without hesitation, she breathes fire and leaps straight at you, before you even have time to let go of the capsa.

The door behind her opens silently as she tackles you to the ground.
[Scene 'Entire Game' ends]

    *** You have been captured. ***

Would you like to RESTART, RESTORE a saved game, QUIT, or UNDO the last command?

>undo
Librum Landing Cradle
[Previous turn undone.]

>d
You tuck in your wings and dive down into the forest below the Aerie, dodging tightly-spaced trees with acrobatic precision.

In the Forest
The trees below the Royal Aerie grow more closely together than in the rest of the forest, and include a wider variety, so that differently-colored woods could be incorporated into the buildings above.  This makes it harder to navigate down here--or it would if you weren't so amazing at navigation.

Even through the mist, your sharp eyes spot a fine net, stretched between the trees.  It seems to be set to prevent anyone from coming up from the forest below.

[Scene 'Momentum' begins]

>open purple
You open the purple capsa of opening, revealing a scroll of rezrov.

[Scene 'Everything Is Open' begins]
As you open the purple capsa, an almost-palpable wave of force emanates from it, as the power of the revealed scroll of rezrov is released.

The magic of the gold capsa of down prevents it from being opened.
The magic of the red capsa of hasten prevents it from being opened.
The straps and buckles on your rucksack fly open and it falls!

Dropped.

[Scene 'Being Chased' begins]
From... well, from everywhere in the Aerie, it seems, Woodpeckers start drumming out messages in their Pounding dialect:  "Intruder! Estimated direction is..." and then each one individually seems to be telegraphing the direction from them to you.  You can't discern any one drummer from any other drummer, but you can at least tell that each seems to be drumming on sheets of metal that differ from each other, as the frequencies are all different from each other.  That makes the information somewhat useless to you, because you've not been trained to distinguish Pounding at different frequencies.  And because you already know where you are.  Sadly, the Raven Guards are indeed trained to distinguish Pounding frequencies.

And if they didn't know where you were, they do now.

[Scene 'Momentum' ends]
The momentum you had from your dive wears off.

>close purple
You close the purple capsa of opening.

[Scene 'Everything Is Open' ends]
[Scene 'Reset Sensors' begins]
[Scene 'Doors Re-close' begins]
From everywhere in the Aerie, you hear the woodpeckers drumming in the Pounding dialect: "Reset Locks!  Repeat!  Reset Locks!

>z
Time passes.

>z
Time passes.

>scenes
Scene 'Entire Game' playing (for 12 mins now)
Scene 'Starting Off' ended
Scene 'Everything Is Open' ended
Scene 'Reset Sensors' playing (for 4 mins now)
Scene 'Doors Re-close' playing (for 4 mins now)
Scene 'Momentum' ended
Scene 'Being Chased' playing (for 5 mins now)
(Scene monitoring now switched on. Type "scenes off" to switch it off again.)

* * *

>open gold
You open the gold capsa of down, revealing a scroll of rudenj.

Immediately, "down" now means "towards the gold capsa" instead of "towards the earth".  Even being ready for it, it takes you a few flaps to reorient yourself, and you blink away the slight dizziness.  Then you pause.  No sounds from the Aerie.  Apparently, the new "down" is close enough to the old "down" that whatever sensors they have up there didn't detect a change.  Good.

The momentum you had from your dive wears off.  Fun while it lasted!

>close gold
You close the gold capsa of down.

You steady yourself as "down" returns to its normal state.

>open purple
You open the purple capsa of opening, revealing a scroll of rezrov.

As you open the purple capsa, an almost-palpable wave of force emanates from it, as the power of the revealed scroll of rezrov is released.

The magic of the gold capsa of down prevents it from being opened.
The magic of the red capsa of hasten prevents it from being opened.
The straps and buckles on your rucksack fly open and it falls!

Dropped.

From... well, from everywhere in the Aerie, it seems, Woodpeckers start drumming out messages in their Pounding dialect:  "Intruder! Estimated direction is..." and then each one individually seems to be telegraphing the direction from them to you.  You can't discern any one drummer from any other drummer, but you can at least tell that each seems to be drumming on sheets of metal that differ from each other, as the frequencies are all different from each other.  That makes the information somewhat useless to you, because you've not been trained to distinguish Pounding at different frequencies.  And because you already know where you are.  Sadly, the Raven Guards are indeed trained to distinguish Pounding frequencies.

And if they didn't know where you were, they do now.

closeness: 1.

>u
You gracefully flit between the trees back up above the canopy.

Great Hall Landing Cradle
The Landing Cradle of the Great Hall spreads out over nearly a quarter of the vast building.  During your time here, you learned this was so that when a number of important guests and their retinues arrive at the same time, they can land simultaneously, instead of one after the other, which some would invariably take as meaning "in order of importance".  The huge double doors of the Great Hall are on the west side of the landing cradle, and unguarded.

To the north is the Royal Quarters and Gardens, the Librum to the east, and as always, you can return to the skies or descend to the forest.

closeness: 2.
Your ascent brings you right into a squad of Raven Guards, on their way to accost you.  You see them only barely before they see you, and it's just enough to mostly avoid them.  Still, a slash from a Raven Guard beak catches you in the side as you twist past.

>u
High Above the Royal Aerie
Your summoned mist both obscures you and blocks you from seeing the Royal Aerie.  But you've already memorized its layout, and how it relates to today's air currents, winds, and thermals.  Royal Quarters to the north, well defended by circling Raven clan guards.  The librum to the east.  In the center of the Aerie (and directly below you) is the Great Hall.  Other royal aeries dot the forest in the distance, but this complex holds your quarry.

closeness: 3.
The Raven Squad pursues you determinedly through the thin mist.

>d
You tuck in your wings and dive down  towards the Aerie, thrilling to the misty wind streaming through your feathers.

Great Hall Landing Cradle
The Landing Cradle of the Great Hall spreads out over nearly a quarter of the vast building.  During your time here, you learned this was so that when a number of important guests and their retinues arrive at the same time, they can land simultaneously, instead of one after the other, which some would invariably take as meaning "in order of importance".  The huge double doors of the Great Hall are on the west side of the landing cradle, and unguarded.

To the north is the Royal Quarters and Gardens, the Librum to the east, and as always, you can return to the skies or descend to the forest.

closeness: 3.
Your speed puts more distance between you and your pursuers, but it's not quite fast enough, or the mist isn't thick enough, or both, and your pursuers manage to keep you in sight.

>d
In the Forest
The trees below the Royal Aerie grow more closely together than in the rest of the forest, and include a wider variety, so that differently-colored woods could be incorporated into the buildings above.  This makes it harder to navigate down here--or it would if you weren't so amazing at navigation.

Even through the mist, your sharp eyes spot a fine net, stretched between the trees.  It seems to be set to prevent anyone from coming up from the forest below.

You can also see a leather rucksack (in which are a purple capsa of opening (in which is a scroll of rezrov), a gold capsa of down (closed), and a red capsa of hasten (closed)) here.

closeness: 3.
You expertly twist at breakneck speeds, weaving through three Ash trunks, over a branch, and around and behind a Redwood, where you halt, twist, and dive straight down the trunk, out of view of any stray Raven.

The Raven's frustrated caws echo in the mist.  In time, the woodpeckers cease their drumming, and the cawing fades as well.  Protocol would dictate that they return to guarding priority items.  If there were any reserves left, they would be called up, but the Red Plague has affected the Raven Squad as sorely as your own community.

You retrieve your rucksack and any fallen capsae, and plot a now-unseen course back to the familiar currents above the Aerie to ponder your next move.

                                                             *    *    *

>u
You wait, expectantly.

>n
Silently, your cell door unlocks, then swings open.

>d
Well above your cell, you sense rezrov, rudenj, and quiste settle in their movements until they make lazy circles, high above the Aerie. Igram and taclor remain in place, quiet.

It is time.

Forgotten Brig
A small but cosy cell, grown with austerity but basic comfort in mind.  Your now-open cell door leads west.

* * *

>u
You gracefully flit between the trees back up above the canopy.

Great Hall Landing Cradle
The Landing Cradle of the Great Hall spreads out over nearly a quarter of the vast building.  During your time here, you learned this was so that when a number of important guests and their retinues arrive at the same time, they can land simultaneously, instead of one after the other, which some would invariably take as meaning "in order of importance".  The huge double doors of the Great Hall are on the west side of the landing cradle, and unguarded.

To the north is the Royal Quarters and Gardens, the Librum to the east, and as always, you can return to the skies or descend to the forest.

Your ascent brings you right into a squad of Raven Guards, on their way to accost you.  You see them only barely before they see you, and it's just enough to mostly avoid them.  Still, a slash from a Raven Guard beak catches you in the side as you twist past.

>u
High Above the Royal Aerie
Your summoned mist both obscures you and blocks you from seeing the Royal Aerie.  But you've already memorized its layout, and how it relates to today's air currents, winds, and thermals.  Royal Quarters to the north, well defended by circling Raven clan guards.  The librum to the east.  In the center of the Aerie (and directly below you) is the Great Hall.  Other royal aeries dot the forest in the distance, but this complex holds your quarry.

The Raven Guard pursues you determinedly through the thin mist.

>d
You tuck in your wings and dive down  towards the Aerie, thrilling to the misty wind streaming through your feathers.

Great Hall Landing Cradle
The Landing Cradle of the Great Hall spreads out over nearly a quarter of the vast building.  During your time here, you learned this was so that when a number of important guests and their retinues arrive at the same time, they can land simultaneously, instead of one after the other, which some would invariably take as meaning "in order of importance".  The huge double doors of the Great Hall are on the west side of the landing cradle, and unguarded.

To the north is the Royal Quarters and Gardens, the Librum to the east, and as always, you can return to the skies or descend to the forest.

As you dive, you use your knowledge of "true down" to give yourself an edge, pulling around a tree at an angle that should be impossible; diving and twisting through gaps in the  branches that couldn't be done.  Your closest pursuer crashes into a branch, and the others peel off to avoid him.

The Raven's frustrated caws echo in the mist.  In time, the woodpeckers cease their drumming, and the cawing fades as well.  Protocol would dictate that they return to guarding priority items.  If there were any reserves left, they would be called up, but the Red Plague has affected the Raven Guard as sorely as your own community.

You 
You twist and right yourself as "down" returns to its normal state.  The Raven Guards still know where you are, though.

                                                             *    *    *

>d
You wait, expectantly.

>[enter]
Silently, your cell door unlocks, then swings open.

Well above your cell, you sense rezrov, rudenj, and quiste settle in their movements until they make lazy circles, high above the Aerie. Igram and taclor remain in place, quiet.

It is time.

Forgotten Brig
A small but cosy cell, grown with austerity but basic comfort in mind.  Your now-open cell door leads west.

* * *

>scenes
Scene 'Entire Game' playing (for 11 mins now)
Scene 'Starting Off' ended
Scene 'Everything Is Open' playing (for 6 mins now)
Scene 'Everything Falls' ended
Scene 'Momentum' ended
Scene 'Being Chased' ended
Scene 'Not Recovering' playing (for 4 mins now)
Scene 'Horatio's story' playing (for 2 mins now)
(Scene monitoring now switched on. Type "scenes off" to switch it off again.)

>u
You gracefully flit between the trees back up above the canopy.

Great Hall Landing Cradle
The Landing Cradle of the Great Hall spreads out over nearly a quarter of the vast building.  During your time here, you learned this was so that when a number of important guests and their retinues arrive at the same time, they can land simultaneously, instead of one after the other, which some would invariably take as meaning "in order of importance".  The huge double doors of the Great Hall are on the west side of the landing cradle, and unguarded.

To the north is the Royal Quarters and Gardens, the Librum to the east, and as always, you can return to the skies or descend to the forest.

>u
High Above the Royal Aerie
Your summoned mist both obscures you and blocks you from seeing the Royal Aerie.  But you've already memorized its layout, and how it relates to today's air currents, winds, and thermals.  Royal Quarters to the north, well defended by circling Raven clan guards.  The librum to the east.  In the center of the Aerie (and directly below you) is the Great Hall.  Other royal aeries dot the forest in the distance, but this complex holds your quarry.

Constance, a powerful Falcon Clan female, is here, her large black eyes watching you with fierce intensity.

[Scene 'Horatio's story' ends]

                                                             *    *    *

"Good job, Constance," you say as you approach to fly adjacent to her broad circling.

She peers at you, and you know she can make out every barb on each of your feathers.  Patiently, you wait.

"You're Horatio," she finally says.  "Didn't the queen... imprison you for heresy?"

"Indeed," you reply.

"And I just unlocked your cell," she says.

"Indeed," you reply.

"They wouldn't tell me what the heresy was.  I guess that's the point of trying to suppress dangerous ideas."

This time, you just wait, and slightly incline your head.  Saying "Indeed" again might make her self-conscious about her babbling.

There's a pause.

"What was it?" she asks.

1) Tell her about capsae.
2) Tell her what you can do.
3) OK, I'm a tester and I need to skip ahead and be Constance, fiddling with scrolls and stuff.
4) I'm also a tester, and I just want to go back to the beginning of this conversation.

>3
[OK, I'm a tester and I need to skip ahead and be Constance, fiddling with scrolls and stuff.]

Done!  Thank you for testing!  If you want to come back to this conversation at the start, just >TOUCH HORATIO.

High Above the Royal Aerie
Your summoned mist both obscures you and blocks you from seeing the Royal Aerie.  But you've already memorized its layout, and how it relates to today's air currents, winds, and thermals.  Royal Quarters to the north, well defended by circling Raven clan guards.  The librum to the east.  In the center of the Aerie (and directly below you) is the Great Hall.  Other royal aeries dot the forest in the distance, but this complex holds your quarry.

Horatio is here, watching you with quiet aplomb and patience.

[Scene 'Horatio distracts the guard' begins]
With a solemn nod to you, Horatio explains where the black capsa of igram should be, then banks to the east, and descends to the Librum.

>i
You are carrying:
  a leather rucksack (open)
    a blue capsa of mist (closed)
    a red capsa of hasten (closed)
    a purple capsa of opening (open)
      a scroll of rezrov
    a gold capsa of down (closed)

>d
You tuck in your wings and dive down  towards the Aerie, thrilling to the misty wind streaming through your feathers.

Great Hall Landing Cradle
The Landing Cradle of the Great Hall spreads out over nearly a quarter of the vast building.  During your time here, you learned this was so that when a number of important guests and their retinues arrive at the same time, they can land simultaneously, instead of one after the other, which some would invariably take as meaning "in order of importance".  The huge double doors of the Great Hall are on the west side of the landing cradle, and unguarded.

To the north is the Royal Quarters and Gardens, the Librum to the east, and as always, you can return to the skies or descend to the forest.

[Scene 'Momentum' begins]

>scenes off
(Scene monitoring now switched off. Type "scenes" to switch it on again.)

>in
Upper Great Hall
There is a small platform just inside the huge double doors of the Great Hall, and that's it.  The platform is lined with a single elegant grown-mahogany branch that wraps around the whole platform.  It varies in size and thickness, so that all types of feet fit somewhere along it, so people can comfortably launch themselves into the air to glide down to the floor level, or grab it for stability as they return.

The momentum you had from your dive wears off.  Fun while it lasted!

>out
Great Hall Landing Cradle
The Landing Cradle of the Great Hall spreads out over nearly a quarter of the vast building.  During your time here, you learned this was so that when a number of important guests and their retinues arrive at the same time, they can land simultaneously, instead of one after the other, which some would invariably take as meaning "in order of importance".  The huge double doors of the Great Hall are on the west side of the landing cradle, and unguarded.

To the north is the Royal Quarters and Gardens, the Librum to the east, and as always, you can return to the skies or descend to the forest.

Your wound continues to lightly bleed.

>u
High Above the Royal Aerie
Your summoned mist both obscures you and blocks you from seeing the Royal Aerie.  But you've already memorized its layout, and how it relates to today's air currents, winds, and thermals.  Royal Quarters to the north, well defended by circling Raven clan guards.  The librum to the east.  In the center of the Aerie (and directly below you) is the Great Hall.  Other royal aeries dot the forest in the distance, but this complex holds your quarry.

>e
You tuck in your wings and dive down east towards the Aerie, thrilling to the misty wind streaming through your feathers.

Librum Landing Cradle
The Landing Cradle of the Librum is beautifully set with interlocking redwood and pine, suggesting shelves of books.  The Librum Door leads inward to the Librum itself.

To the west is the Great Hall, and to the northwest is the Royal Quarters and Gardens.  You can also re-ascend to the skies or descend to the forest below.

Horatio is talking slowly to the lone guard about the ethics of a monarchy, driving the guard quietly insane.

In the cradle next to the guard is a small pile of tiny padlocks, each open.

* * *

>get black
(the black capsa)
Taken.

>x it
The black capsa contains a scroll of igram, but Horatio won't tell you what that means.  It is closed, preventing the power of the scroll from affecting the area.

>open it
You open the black capsa, revealing a scroll of igram.

For a moment, the purple capsa seems to flicker.  But you look again, and nothing seems to have changed.

>close it
You close the black capsa.

Your wound aches.  You look down at it, and it's still open and bleeding.

>out
Listening to Horatio talk with the guard, you enter the shadows just inside the Librum door, where you can watch the guard but not be seen.  When the moment is right, you launch yourself through, and back up into the safety of the mist.

Librum Landing Cradle
The Landing Cradle of the Librum is beautifully set with interlocking redwood and pine, suggesting shelves of books.  The Librum Door leads inward to the Librum itself.

To the west is the Great Hall, and to the northwest is the Royal Quarters and Gardens.  You can also re-ascend to the skies or descend to the forest below.

Horatio is talking slowly to the lone guard about his grandchildren, driving the guard quietly insane.

In the cradle next to the guard is a small pile of tiny padlocks, each open.

* * *

>close purple
You close the purple capsa of opening.

You feel your skin prickle where you were wounded, and look down.  To your amazement, your wound has closed and the bleeding stopped.  As you watch, even the line from the cut disappears, and the feathers around it fluff out again.

It's the scroll of Health.  It has to be.  It's actually here!  And active.  Hmm.

From everywhere in the Aerie, you hear the woodpeckers drumming in the Pounding dialect: "Reset Locks!  Repeat!  Reset Locks!

>open purple
You open the purple capsa of opening, revealing a scroll of rezrov.

As you open the purple capsa, an almost-palpable wave of force emanates from it, as the power of the revealed scroll of rezrov is released.

The magic of the gold capsa of down prevents it from being opened.
The magic of the red capsa of hasten prevents it from being opened.
The magic of the black capsa prevents it from being opened.
The magic of the blue capsa of mist prevents it from being opened.

>w
Upper Great Hall
There is a small platform just inside the huge double doors of the Great Hall, and that's it.  The platform is lined with a single elegant grown-mahogany branch that wraps around the whole platform.  It varies in size and thickness, so that all types of feet fit somewhere along it, so people can comfortably launch themselves into the air to glide down to the floor level, or grab it for stability as they return.

>w
You can't go that way.

>d
You step on to your favorite spot on the mahogany branch, and launch yourself downward in a graceful glide.

Lower Great Hall
When not prepared for a particular occasion, like now, the floor of the Great Hall is cleared of everything extraneous.  The exposed floor is absolutely exquisite, with swooping lines interspersed with starbursts, all in multicolored woods of all hues.  What doesn't change about the Great Hall floor is the display nooks along the sides: at least twenty nooks containing all manner of artifacts from around the world.

Horatio is here, watching you with quiet aplomb and patience.

You circle down and land near Horatio.  "So.  Now will you tell me what igram does and why it's so important?" you ask.

"It is better to show you," he replies.  "Try it."

You sigh.  Fine.

>x black
(the black capsa)
The black capsa contains a scroll of igram, but Horatio won't tell you what that means.  It is closed, preventing the power of the scroll from affecting the area.

>open black
(the black capsa)
You open the black capsa, revealing a scroll of igram.

For a moment, the purple capsa seems to flicker.  But you look again, and nothing seems to have changed.
Suddenly, two hunting cloaks in a display of ancient pre-historical artifacts disappear!

* * *

>x cloaks
The cloak posts appear to be empty.

>touch cloaks
You reach out and pick up the cloak.  It seems none the worse for wear from having been invisible.  Next to you, Horatio picks up the other.

You turn to Horatio, questions bubbling in your head.  "So, nothing else here turned invisible.  Does the scroll work on cloaks?  Things for hunting?  Ancient materials?  Hides?"

Horatio looks a little uncomfortable.  "No.  It works on... purple."

"Purple?!?" you exclaim/ask.

"Purple," he confirms.

"It turns purple things invisible?  Purple things!  The gift from the gods, on a scroll written in their secret language!  To turn purple things invisible!"  You cackle in glee.

Horatio looks uncomfortably affronted.  "The hippotomai were common in those days.  It made sense..."

You continue to laugh, cutting him off, but unable to contain your utter delight.  "Herds of invisible hippotomai!  Grass on the marshy banks disappearing into nowhere!  Weird divots in the lakes!  I bet--wait!  The trickster god!  Ape, the trickster!  Stohleblanc!"  You laughter gets more hysterical and you nearly can't breathe.

With as much dignity as he can muster, Horatio waits solemnly for you to finish laughing.  You fail to do so.  Finally he gets impatient and turns to go.  "We can enter the Royal Quarters cloaked.  I will follow you."

"Wait," you sputter, trying to push down the hysteria.  "How will you follow me?  I'll be invisible!"

"I can sense the capsae.  I will know where you are," he replies, and with a deep breath, he gathers himself and flies up and out of the Great Hall.

>showme cloak
(the purple hunting cloak)
purple hunting cloak - thing
location: carried by yourself in Lower Great Hall
unlit, inedible, portable, wearable, handled; singular-named, improper-named; invisible
description: "You can feel the supple folds of the cloak, but cannot see it at all."
initial appearance: none
printed name: "purple hunting cloak"
printed plural name: none
indefinite article: none
list grouping key: none

>scenes
Scene 'Entire Game' playing (for 36 mins now)
Scene 'Starting Off' ended
Scene 'Everything Is Open' playing (for 8 mins now)
Scene 'Reset Sensors' playing (for 9 mins now)
Scene 'Doors Re-close' ended
Scene 'Everything Falls' ended
Scene 'No More Purple' playing (for 3 mins now)
Scene 'Momentum' ended
Scene 'Being Chased' ended
Scene 'Not Recovering' ended
Scene 'Actually Recovering' ended
Scene 'Horatio's story' ended
Scene 'Horatio distracts the guard' ended
Scene 'Horatio tries to make zgi less ridiculous' ended
(Scene monitoring now switched on. Type "scenes off" to switch it off again.)

* * *

>e
Librum Landing Cradle
The Landing Cradle of the Librum is beautifully set with interlocking redwood and pine, suggesting shelves of books.  The Librum Door leads inward to the Librum itself.

To the west is the Great Hall, and to the northwest is the Royal Quarters and Gardens.  You can also re-ascend to the skies or descend to the forest below.

A lone Raven guard stands in front of the door, dark eyes shifting as she watches the mist.

>in
(first opening Librum Door)
The guard is entirely too watchful to let you do that.

* * *

>open purple
You open the purple capsa of opening, revealing a scroll of rezrov.

As you open the purple capsa, an almost-palpable wave of force emanates from it, as the power of the revealed scroll of rezrov is released.

The huge double doors of the Great Hall clicks as it unlocks!
The magic of the gold capsa of down prevents it from being opened.
The magic of the red capsa of hasten prevents it from being opened.
The huge double doors of the Great Hall flies open!
The straps and buckles on your rucksack fly open and it falls!

Dropped.

From... well, from everywhere in the Aerie, it seems, Woodpeckers start drumming out messages in their Pounding dialect:  "Intruder! Estimated direction is..." and then each one individually seems to be telegraphing the direction from them to you.  You can't discern any one drummer from any other drummer, but you can at least tell that each seems to be drumming on sheets of metal that differ from each other, as the frequencies are all different from each other.  That makes the information somewhat useless to you, because you've not been trained to distinguish Pounding at different frequencies.  And because you already know where you are.  Sadly, the Raven Guards are indeed trained to distinguish Pounding frequencies.

And if they didn't know where you were, they do now.

closeness: 1.

>e
Librum Landing Cradle
The Landing Cradle of the Librum is beautifully set with interlocking redwood and pine, suggesting shelves of books.  The Librum Door leads inward to the Librum itself.

To the west is the Great Hall, and to the northwest is the Royal Quarters and Gardens.  You can also re-ascend to the skies or descend to the forest below.

closeness: 2.
You've barely left Great Hall Landing Cradle when a squad of Raven Guards wheels in from behind, hot on your tail!

>in
You fly through the door, and immediately regret your decision.  In an instant, the Raven Squad has followed you, and you simply don't have any room to maneuver.

    *** You have been captured. ***

Would you like to RESTART, RESTORE a saved game, QUIT, or UNDO the last command?

>undo
Librum Landing Cradle
[Previous turn undone.]

>enter door
You fly through the door, and immediately regret your decision.  In an instant, the Raven Squad has followed you, and you simply don't have any room to maneuver.

    *** You have been captured. ***

Would you like to RESTART, RESTORE a saved game, QUIT, or UNDO the last command?

>undo
Librum Landing Cradle
[Previous turn undone.]

>w
Great Hall Landing Cradle
The Landing Cradle of the Great Hall spreads out over nearly a quarter of the vast building.  During your time here, you learned this was so that when a number of important guests and their retinues arrive at the same time, they can land simultaneously, instead of one after the other, which some would invariably take as meaning "in order of importance".  The huge double doors of the Great Hall are on the west side of the landing cradle, and unguarded.

To the north is the Royal Quarters and Gardens, the Librum to the east, and as always, you can return to the skies or descend to the forest.

You can see a leather rucksack (in which are a purple capsa of opening (in which is a scroll of rezrov), a gold capsa of down (closed), and a red capsa of hasten (closed)) here.

closeness: 3.
The Raven Squad pursues you determinedly through the thin mist.

>in
You fly through the door, and immediately regret your decision.  In an instant, the Raven Squad has followed you, and you simply don't have any room to maneuver.

    *** You have been captured. ***

Would you like to RESTART, RESTORE a saved game, QUIT, or UNDO the last command?

>undo
Great Hall Landing Cradle
[Previous turn undone.]

>enter door
You fly through the door, and immediately regret your decision.  In an instant, the Raven Squad has followed you, and you simply don't have any room to maneuver.

    *** You have been captured. ***

Would you like to RESTART, RESTORE a saved game, QUIT, or UNDO the last command?

* * *

>w
You can't go that way.

* * *

>summon mist
Calling on your heritage as a Bostrat, you summon moisture from the air, and it slowly coalesces into a creeping grey mist, obscuring you from sight.  In gentler times, you would be doing this to ensure the growth of the fields and forests; now you must use it to hide from prying eyes that would keep you from your quarry.

You stop at the natural inflection point for clouds given today's weather.  You could make it thicker still, but it would then start to dissapate.

>open gold
You open the gold capsa of down, revealing a scroll of rudenj.

Immediately, "down" now means "towards the gold capsa" instead of "towards the earth".  After a brief moment of disorientation, you right yourself, wings pulling you "up" with just enough force that you remain in one place.

Note: for convenience, "down" and "up" comands will continue to work as they did, referencing Earth-relative geography instead of gold capsa-relative geography.

From... well, from everywhere in the Aerie, it seems, Woodpeckers start drumming out messages in their Pounding dialect:  "Intruder!  The enemy is DOWN. Repeat!  The enemy is DOWN."  You realize that creating a gravity well pointing straight at you might not have been the wisest move.

closeness: 1.

>open purple
You open the purple capsa of opening, revealing a scroll of rezrov.

As you open the purple capsa, an almost-palpable wave of force emanates from it, as the power of the revealed scroll of rezrov is released.

The magic of the red capsa of hasten prevents it from being opened.
The straps and buckles on your rucksack fly open and it falls!
Fortunately, it hovers in midair due to the scroll of down, so you're able to immediately grab it again.

closeness: 2.
A squad of Raven Guards appears, and their war cries exalt as they spot you.  You weave through the air, tumbling and twisting as you try to avoid them.

* * *

>summon mist
Calling on your heritage as a Bostrat, you summon moisture from the air, and it slowly coalesces into a creeping grey mist, obscuring you from sight.  In gentler times, you would be doing this to ensure the growth of the fields and forests; now you must use it to hide from prying eyes that would keep you from your quarry.

You stop at the natural inflection point for clouds given today's weather.  You could make it thicker still, but it would then start to dissapate.

>open purple
You open the purple capsa of opening, revealing a scroll of rezrov.

As you open the purple capsa, an almost-palpable wave of force emanates from it, as the power of the revealed scroll of rezrov is released.

The magic of the gold capsa of down prevents it from being opened.
The magic of the red capsa of hasten prevents it from being opened.
The straps and buckles on your rucksack fly open and it falls!

The leather rucksack twists away as it falls below you, towards the Great Hall.

From... well, from everywhere in the Aerie, it seems, Woodpeckers start drumming out messages in their Pounding dialect:  "Intruder! Estimated direction is..." and then each one individually seems to be telegraphing the direction from them to you.  You can't discern any one drummer from any other drummer, but you can at least tell that each seems to be drumming on sheets of metal that differ from each other, as the frequencies are all different from each other.  That makes the information somewhat useless to you, because you've not been trained to distinguish Pounding at different frequencies.  And because you already know where you are.  Sadly, the Raven Guards are indeed trained to distinguish Pounding frequencies.

And if they didn't know where you were, they do now.

closeness: 1.

>close purple
You can't see any such thing.

* * *

>summon mist
Calling on your heritage as a Bostrat, you summon moisture from the air, and it slowly coalesces into a creeping grey mist, obscuring you from sight.  In gentler times, you would be doing this to ensure the growth of the fields and forests; now you must use it to hide from prying eyes that would keep you from your quarry.

You stop at the natural inflection point for clouds given today's weather.  You could make it thicker still, but it would then start to dissapate.

>take off purple
You aren't wearing the purple capsa of opening.

>take off rucksack
You take off the leather rucksack.

>open purple
You open the purple capsa of opening, revealing a scroll of rezrov.

As you open the purple capsa, an almost-palpable wave of force emanates from it, as the power of the revealed scroll of rezrov is released.

The magic of the gold capsa of down prevents it from being opened.
The magic of the red capsa of hasten prevents it from being opened.

From... well, from everywhere in the Aerie, it seems, Woodpeckers start drumming out messages in their Pounding dialect:  "Intruder! Estimated direction is..." and then each one individually seems to be telegraphing the direction from them to you.  You can't discern any one drummer from any other drummer, but you can at least tell that each seems to be drumming on sheets of metal that differ from each other, as the frequencies are all different from each other.  That makes the information somewhat useless to you, because you've not been trained to distinguish Pounding at different frequencies.  And because you already know where you are.  Sadly, the Raven Guards are indeed trained to distinguish Pounding frequencies.

And if they didn't know where you were, they do now.

closeness: 1.

>close purple
You close the purple capsa of opening.

From everywhere in the Aerie, you hear the woodpeckers drumming in the Pounding dialect: "Reset Locks!  Repeat!  Reset Locks!

closeness: 2.
A squad of Raven Guards appears, and their war cries exalt as they spot you.  You weave through the air, tumbling and twisting as you try to avoid them.

>z
Time passes.

closeness: 3.
The guards charge, but you manage to evade their uncoordinated attack.

>scenes
Scene 'Entire Game' playing (for 6 mins now)
Scene 'Starting Off' playing (for 6 mins now)
Scene 'Everything Is Open' ended
Scene 'Reset Sensors' playing (for 2 mins now)
Scene 'Doors Re-close' playing (for 2 mins now)
Scene 'Being Chased' playing (for 3 mins now)
(Scene monitoring now switched on. Type "scenes off" to switch it off again.)

* * *

>take off rucksack
You take off the leather rucksack.

>summon mist
Calling on your heritage as a Bostrat, you summon moisture from the air, and it slowly coalesces into a creeping grey mist, obscuring you from sight.  In gentler times, you would be doing this to ensure the growth of the fields and forests; now you must use it to hide from prying eyes that would keep you from your quarry.

You stop at the natural inflection point for clouds given today's weather.  You could make it thicker still, but it would then start to dissapate.

>open purple
You open the purple capsa of opening, revealing a scroll of rezrov.

As you open the purple capsa, an almost-palpable wave of force emanates from it, as the power of the revealed scroll of rezrov is released.

The magic of the gold capsa of down prevents it from being opened.
The magic of the red capsa of hasten prevents it from being opened.

From... well, from everywhere in the Aerie, it seems, Woodpeckers start drumming out messages in their Pounding dialect:  "Intruder! Estimated direction is..." and then each one individually seems to be telegraphing the direction from them to you.  You can't discern any one drummer from any other drummer, but you can at least tell that each seems to be drumming on sheets of metal that differ from each other, as the frequencies are all different from each other.  That makes the information somewhat useless to you, because you've not been trained to distinguish Pounding at different frequencies.  And because you already know where you are.  Sadly, the Raven Guards are indeed trained to distinguish Pounding frequencies.

And if they didn't know where you were, they do now.

>d
You descend in wide circles, pulling mist down with you in what you hope is a sufficiently unsuspicious manner, trusting your memorization of the air currents to tell you where you're going...

Great Hall Landing Cradle
The Landing Cradle of the Great Hall spreads out over nearly a quarter of the vast building.  During your time here, you learned this was so that when a number of important guests and their retinues arrive at the same time, they can land simultaneously, instead of one after the other, which some would invariably take as meaning "in order of importance".  The huge double doors of the Great Hall are on the west side of the landing cradle, and unguarded.

To the north is the Royal Quarters and Gardens, the Librum to the east, and as always, you can return to the skies or descend to the forest.

You've dived straight into a squad of Raven Guards, on their way up to accost you.  Fortunately, your speed helped you avoid most of them, but one guard's talon catches you on your side as you twist by them.

>u
High Above the Royal Aerie
Your summoned mist both obscures you and blocks you from seeing the Royal Aerie.  But you've already memorized its layout, and how it relates to today's air currents, winds, and thermals.  Royal Quarters to the north, well defended by circling Raven clan guards.  The librum to the east.  In the center of the Aerie (and directly below you) is the Great Hall.  Other royal aeries dot the forest in the distance, but this complex holds your quarry.

The Raven Guard pursues you determinedly through the thin mist.

>d
You tuck in your wings and dive down  towards the Aerie, thrilling to the misty wind streaming through your feathers.

Great Hall Landing Cradle
The Landing Cradle of the Great Hall spreads out over nearly a quarter of the vast building.  During your time here, you learned this was so that when a number of important guests and their retinues arrive at the same time, they can land simultaneously, instead of one after the other, which some would invariably take as meaning "in order of importance".  The huge double doors of the Great Hall are on the west side of the landing cradle, and unguarded.

To the north is the Royal Quarters and Gardens, the Librum to the east, and as always, you can return to the skies or descend to the forest.

Your speed puts more distance between you and your pursuers, but it's not quite fast enough, or the mist isn't thick enough, or both, and your pursuers manage to keep you in sight.

>d
In the Forest
The trees below the Royal Aerie grow more closely together than in the rest of the forest, and include a wider variety, so that differently-colored woods could be incorporated into the buildings above.  This makes it harder to navigate down here--or it would if you weren't so amazing at navigation.

Even through the mist, your sharp eyes spot a fine net, stretched between the trees.  It seems to be set to prevent anyone from coming up from the forest below.

You expertly twist at breakneck speeds, weaving through three Ash trunks, over a branch, and around and behind a Redwood, where you halt, twist, and dive straight down the trunk, out of view of any stray Raven.

The Raven's frustrated caws echo in the mist.  In time, the woodpeckers cease their drumming, and the cawing fades as well.  Protocol would dictate that they return to guarding priority items.  If there were any reserves left, they would be called up, but the Red Plague has affected the Raven Guard as sorely as your own community.

You 

                                                             *    *    *

* * *

You wait, expectantly.

* * *

>w
Disused Hallway
The only time you ever saw anyone in this hallway was when Georg came to give you your meals, or clean the cell.  The living walls, still elegantly patterned, even here, self-replenish, and the floor carries away shed bark through the grate.  It leads west into the living area, and your old cell door leads east.

>enter grate
You flatten yourself to the floor and, hearing your bones creak, roll into the space behind the grate.  Using your minimal throck ability, you whisper to the veins of this place: "I am extra.  I am not needed.  Take me from this place, which will renew itself through my absence."

After a few moments, you feel an undulation in the slick rippled floor beneath you, and you are compressed even further, as its peristalsis slides you slowly, and then more rapidly, away from your only home for the last ten years.  Then with a sudden >plop<, you're ejected into space.

You try to spread your wings, but your reaction time is not what it was, and you hit wirey netting before fully stopping yourself.

No matter.

In the Forest
The trees below the Royal Aerie grow more closely together than in the rest of the forest, and include a wider variety, so that differently-colored woods could be incorporated into the buildings above.  This makes it harder to navigate down here--or it would if you weren't so amazing at navigation.

Even through the mist, your sharp eyes spot a fine net, stretched between the trees.  It seems to be set to prevent anyone from coming up from the forest below.

>u
You gracefully flit between the trees back up above the canopy.

Great Hall Landing Cradle
The Landing Cradle of the Great Hall spreads out over nearly a quarter of the vast building.  During your time here, you learned this was so that when a number of important guests and their retinues arrive at the same time, they can land simultaneously, instead of one after the other, which some would invariably take as meaning "in order of importance".  The huge double doors of the Great Hall are on the west side of the landing cradle, and unguarded.

To the north is the Royal Quarters and Gardens, the Librum to the east, and as always, you can return to the skies or descend to the forest.

>u
High Above the Royal Aerie
Your summoned mist both obscures you and blocks you from seeing the Royal Aerie.  But you've already memorized its layout, and how it relates to today's air currents, winds, and thermals.  Royal Quarters to the north, well defended by circling Raven clan guards.  The librum to the east.  In the center of the Aerie (and directly below you) is the Great Hall.  Other royal aeries dot the forest in the distance, but this complex holds your quarry.

Constance, a powerful Falcon Clan female, is here, her large black eyes watching you with fierce intensity.

                                                             *    *    *

* * *

>1
[Tell her about capsae.]

"I believe that the gods gave us the capsae to benefit everyone," you say.

Constance frowns.  "That's not... a dangerous idea.  I mean, people may not truly believe in the gods much today, but they're generally seen as having been... nice?  I guess?"

1) Explain.
2) OK, I'm a tester and I need to go back and check Constance fiddling with scrolls and stuff.
3) I'm also a tester, and I just want to go back to the beginning of this conversation.

>1
[Explain.]

"When I say everyone, I mean everyone.  In the whole world.  As far as the Clans extend."

Constance chuckles.  "A little hard for the capsae to do that.  Longest range I know of is, like, two miles."

"Indeed," you reply.

Constance locks her wings so she can turn and look at you intently for several seconds as she glides.  She probably thinks she's being tested.  Which would be good, because she is.  You wait.

"So.  You believe that the capsae are being misused.  That the kingdoms hoarding them should instead... share them?  Move them around?  Shuffle them, so each kingdom gets a bit of their power every so often?"

"Misused, yes," you reply.  "And, yes, it would be in the spirit of that initial gift to share them more.  But what I proposed to your queen, and to other queens and kings of other realms, goes beyond this."

Constance thinks for a bit.  Then she rolls her eyes.  "OK, yeah, I have no idea what you're talking about."

1) Ask her about scrolls.
2) Tell her about scrolls.
3) OK, I'm a tester and I need to go back and check Constance fiddling with scrolls and stuff.
4) I'm also a tester, and I just want to go back to the beginning of this conversation.

>2
[Tell her about scrolls.]

"The scrolls were meant to be read, not hoarded", you say.

Constance thinks.  "Hmm.  So, you want to research the dead language on the scrolls?  Figure it out again?  Do some sort of cross-Kingdom research project, where everyone agrees to send the texts of their capsae to everyone else?  That seems reasonable, but again, it's not a particularly dangerous idea."

1) Tell her what you can do.

>1
[Tell her what you can do.]

"You've seen the scrolls themselves?  The writing on them?"

"'Indeed,'" Constance replies, raising an eyebrow.  You grin.

"What you may not know is that those symbols are not found in any other form of known writing.  There are fragments of writing from before the capsae.  They differ.  Some say it is the language of the gods themselves."

"Woo, fancy," says Constance.  "In other words, they're gibberish."

"No," you reply.  "I can read them."

"Oh?  What do they say?" Constance asks.

1) Tell her the truth.
2) Wax poetical a bit.
3) OK, I'm a tester and I need to go back and check Constance fiddling with scrolls and stuff.
4) I'm also a tester, and I just want to go back to the beginning of this conversation.

>1
[Tell her the truth.]

"I don't know," you tell her.

Constance sputters.  "But you--" she begins, then cuts herself off, looking at you askance again.  She's a clever woman.  You wait, tipping your wings synchronously with hers as you turn into another circuit.

"So.  You learned the language from somewhere."  She thinks.  You wait.  "No, you said the symbols matched no other writing.  You were born knowing the language.  It's your heritage, as I was born knowing how to summon mist."

You let her think, the lack of any contradiction from you enough of an encouragement.

"Which means you've either just never seen an actual scroll--which seems unlikely; the queen didn't get mad at you until several days had passed--or," she slows down, but continues, "or you were born with the ability to read, but not understand."

"Inde--"  Constance shoots you warning look.  "Yes.  That's it exactly.  Congratulations."  You bob your head and splay your wingfeathers in a grin of approval.

"So, you want to read a capsa's scroll.  And you won't know what you're reading." says Constance.

1) Share your speculation.
2) OK, I'm a tester and I need to go back and check Constance fiddling with scrolls and stuff.
3) I'm also a tester, and I just want to go back to the beginning of this conversation.

>undo
High Above the Royal Aerie
[Previous turn undone.]

>2
[Wax poetical a bit.]

"I have read and felt what it was like to thunder across the plains as a gazelle from the scroll of izyuk.  I have read and felt the desperate yen of attraction from the scroll of obidil. From the scroll you now hold in your posession, I have read and felt what it is to be the very earth itself, spinning through the cosmos."

Constance looks at you.  A beat.  "So you don't know."

"I don't know," you agree.

Constance waits.  OK, you can give her this one.

"I don't know because reading is my heritage, as the ability to summon mist is yours.  But understanding is not part of that gift."

"Well that sucks," Constance says.

"It is a touch of the language of the gods," you say, simply.  "It is enough."

The two of you make another circuit.  The mist streams off the ends of your outstretched wings in curled eddies.

"So, you want to read a capsa's scroll.  And you won't know what you're reading." says Constance, after a bit.

1) Share your speculation.
2) OK, I'm a tester and I need to go back and check Constance fiddling with scrolls and stuff.
3) I'm also a tester, and I just want to go back to the beginning of this conversation.

>1
[Share your speculation.]

"I will not know what it is I'm saying, but I have a guess about what will happen.

And no capsae holder I have yet met will risk such a thing," you say.

Constance scoffs.  "No Queen or King, you mean.

"You personally currently hold three capsae, more than some kingdoms."

Constance laughs.  "'Cause I stole 'em!  And they weren't even the one I wanted; I just didn't know what color I was after

1) OK, I'm a tester and I need to go back and check Constance fiddling with scrolls and stuff.
2) I'm also a tester, and I just want to go back to the beginning of this conversation.

>showme h2
There seems to be no such object anywhere in the model world.

>showme page
There seems to be no such object anywhere in the model world.

>tree
That command isn't available in choice mode.

>1
[OK, I'm a tester and I need to go back and check Constance fiddling with scrolls and stuff.]

Done!  Thank you for testing!  If you want to come back to this conversation at the start, just >TOUCH HORATIO.

High Above the Royal Aerie
Your summoned mist both obscures you and blocks you from seeing the Royal Aerie.  But you've already memorized its layout, and how it relates to today's air currents, winds, and thermals.  Royal Quarters to the north, well defended by circling Raven clan guards.  The librum to the east.  In the center of the Aerie (and directly below you) is the Great Hall.  Other royal aeries dot the forest in the distance, but this complex holds your quarry.

Horatio is here, watching you with quiet aplomb and patience.

>undo
High Above the Royal Aerie
[Previous turn undone.]

>l
"You personally currently hold three capsae, more than some kingdoms."

Constance laughs.  "'Cause I stole 'em!  And they weren't even the one I wanted; I just didn't know what color I was after

1) OK, I'm a tester and I need to go back and check Constance fiddling with scrolls and stuff.
2) I'm also a tester, and I just want to go back to the beginning of this conversation.

>2
[I'm also a tester, and I just want to go back to the beginning of this conversation.]

Done!  Thank you for testing!

                                                             *    *    *

"Good job, Constance," you say as you approach to fly adjacent to her broad circling.

She peers at you, and you know she can make out every barb on each of your feathers.  Patiently, you wait.

"You're Horatio," she finally says.  "Didn't the queen... imprison you for heresy?"

"Indeed," you reply.

"And I just unlocked your cell," she says.

"Indeed," you reply.

"They wouldn't tell me what the heresy was.  I guess that's the point of trying to suppress dangerous ideas."

This time, you just wait, and slightly incline your head.  Saying "Indeed" again might make her self-conscious about her babbling.

There's a pause.

"What was it?" she asks.

1) Tell her about capsae.
2) Tell her what you can do.
3) OK, I'm a tester and I need to go back and check Constance fiddling with scrolls and stuff.
4) I'm also a tester, and I just want to go back to the beginning of this conversation.

>3
[OK, I'm a tester and I need to go back and check Constance fiddling with scrolls and stuff.]

Done!  Thank you for testing!  If you want to come back to this conversation at the start, just >TOUCH HORATIO.

High Above the Royal Aerie
Your summoned mist both obscures you and blocks you from seeing the Royal Aerie.  But you've already memorized its layout, and how it relates to today's air currents, winds, and thermals.  Royal Quarters to the north, well defended by circling Raven clan guards.  The librum to the east.  In the center of the Aerie (and directly below you) is the Great Hall.  Other royal aeries dot the forest in the distance, but this complex holds your quarry.

Horatio is here, watching you with quiet aplomb and patience.

>actions
Actions listing on.

>touch horatio
[touching Horatio]
[(1) looking]
"Good job, Constance," you say as you approach to fly adjacent to her broad circling.

She peers at you, and you know she can make out every barb on each of your feathers.  Patiently, you wait.

"You're Horatio," she finally says.  "Didn't the queen... imprison you for heresy?"

"Indeed," you reply.

"And I just unlocked your cell," she says.

"Indeed," you reply.

"They wouldn't tell me what the heresy was.  I guess that's the point of trying to suppress dangerous ideas."

This time, you just wait, and slightly incline your head.  Saying "Indeed" again might make her self-conscious about her babbling.

There's a pause.

"What was it?" she asks.

1) Tell her about capsae.
2) Tell her what you can do.
3) OK, I'm a tester and I need to go back and check Constance fiddling with scrolls and stuff.
4) I'm also a tester, and I just want to go back to the beginning of this conversation.

[(1) looking - succeeded]

[touching Horatio - failed]

>actions off
That command isn't available in choice mode.

>actions
That command isn't available in choice mode.

* * *

>2
[Tell her what you can do.]

"You've seen the scrolls themselves?  The writing on them?"

"'Indeed,'" Constance replies, raising an eyebrow.  You grin.

"What you may not know is that those symbols are not found in any other form of known writing.  There are fragments of writing from before the capsae.  They differ.  Some say it is the language of the gods themselves."

"Woo, fancy," says Constance.  "In other words, they're gibberish."

"No," you reply.  "I can read them."

"Oh?  What do they say?" Constance asks.

1) Tell her the truth.
2) Wax poetical a bit.
3) OK, I'm a tester and I need to skip ahead and be Constance, fiddling with scrolls and stuff.
4) I'm also a tester, and I just want to go back to the beginning of this conversation.

>2
[Wax poetical a bit.]

"I have read and felt what it was like to thunder across the plains as a gazelle from the scroll of izyuk.  I have read and felt the desperate yen of attraction from the scroll of obidil. From the scroll you now hold in your posession, I have read and felt what it is to be the very earth itself, spinning through the cosmos."

Constance looks at you.  A beat.  "So you don't know."

"I don't know," you agree.

Constance waits.  OK, you can give her this one.

"I don't know because reading is my heritage, as the ability to summon mist is yours.  But understanding is not part of that gift."

"Well that sucks," Constance says.

"It is a touch of the language of the gods," you say, simply.  "It is enough."

The two of you make another circuit.  The mist streams off the ends of your outstretched wings in curled eddies.

"So I assume this is some sort of backstory for what your heresy actually is?" Constance finally asks.

1) Tell her about capsae.
2) OK, I'm a tester and I need to go back and check Constance fiddling with scrolls and stuff.
3) I'm also a tester, and I just want to go back to the beginning of this conversation.

>1
[Tell her about capsae.]

"I believe that the gods gave us the capsae to benefit everyone," you say.

Constance frowns.  "That's not... a dangerous idea.  I mean, people may not truly believe in the gods much today, but they're generally seen as having been... nice?  I guess?"

1) Explain.
2) OK, I'm a tester and I need to go back and check Constance fiddling with scrolls and stuff.
3) I'm also a tester, and I just want to go back to the beginning of this conversation.

>1
[Explain.]

"When I say everyone, I mean everyone.  In the whole world.  As far as the Clans extend."

Constance chuckles.  "A little hard for the capsae to do that.  Longest range I know of is, like, two miles."

"Indeed," you reply.

Constance locks her wings so she can turn and look at you intently for several seconds as she glides.  She probably thinks she's being tested.  Which would be good, because she is.  You wait.

"So.  You believe that the capsae are being misused.  That the kingdoms hoarding them should instead... share them?  Move them around?  Shuffle them, so each kingdom gets a bit of their power every so often?"

"Misused, yes," you reply.  "And, yes, it would be in the spirit of that initial gift to share them more.  But what I proposed to your queen, and to other queens and kings of other realms, goes beyond this."

Constance thinks for a bit.  Then her eyes widen.  "You want to read the scrolls!" she exclaims.

1) Share your speculation.
2) OK, I'm a tester and I need to go back and check Constance fiddling with scrolls and stuff.
3) I'm also a tester, and I just want to go back to the beginning of this conversation.

>1
[Share your speculation.]

"I will not know what it is I'm saying, but I have a guess about what will happen.

And no capsae holder I have yet met will risk such a thing," you say.

1) {Switching to Constance}: Scoff at "capsae holder".
2) {Switching to Constance}: Ask about his guess.
3) OK, I'm a tester and I need to go back and check Constance fiddling with scrolls and stuff.
4) I'm also a tester, and I just want to go back to the beginning of this conversation.

>1
[{Switching to Constance}: Scoff at "capsae holder".]

You scoff.  "No Queen or King, you mean.

"You personally currently hold three capsae, more than some kingdoms," replies Horatio,

You laugh.  "'Cause I stole 'em!  And they weren't even the one I wanted; I just didn't know what color I was after!"

"Nevertheless," you tell her, "you are their holder. If you told me you wanted me to read one, I then could.

1) He needs instructions?
2) Ask about his guess.
3) OK, I'm a tester and I need to go back and check Constance fiddling with scrolls and stuff.
4) I'm also a tester, and I just want to go back to the beginning of this conversation.

>1
[He needs instructions?]

"Wait.  So, I could order you to read a capsa?  And the magic would compel you to do it?" you ask, incredulously.

"No.  I will not read one without the holder's permission, but I may refuse any order," Horatio replies.

"'Will not.'  So you're not compelled to do anything.  It's just a personal choice," you say.

Horatio winces slightly.  "I suppose, technically, you are correct.  It is a tradition among the Readers who know the history."

1) Getting information out of this guy is like pulling mist out of the desert.  Say nothing.
2) OK, I'm a tester and I need to go back and check Constance fiddling with scrolls and stuff.
3) I'm also a tester, and I just want to go back to the beginning of this conversation.

>1
[Getting information out of this guy is like pulling mist out of the desert.  Say nothing.]

You say nothing, and wait expectantly.

In response, Horatio offers you the blue capsa he's holding.  It's closed, and you cock your head questioningly at him.  "It safe.  Nothing will happen when you open it."

Weird trap if it was a trap.  Fine.  You open the blue capsa, bracing yourself... and nothing happens.  You look at the scroll, which seems to have no symbols on it at all apart from the title:  "BOSTRAT".

1) Is that real?
2) Wow.
3) OK, I'm a tester and I need to go back and check Constance fiddling with scrolls and stuff.
4) I'm also a tester, and I just want to go back to the beginning of this conversation.

>1
[Is that real?]

Horatio shrugs.  "I cannot prove it is so.  Many have chosen not to believe.  But I can sense capsae, and I can sense this."

1) Wow.
2) OK, I'm a tester and I need to go back and check Constance fiddling with scrolls and stuff.
3) I'm also a tester, and I just want to go back to the beginning of this conversation.

>1
[Wow.]

"Wow," you say, amazed by the implication.

"Indeed," Horatio replies.  "At one time, if my research and the ancient tales I have collected are correct, this capsa, when activated, would bring rain to the land around it."

"And now... any Bostrat anywhere in the world can bring rain," you conclude.  "If they work together," you amend.

Horatio nods, seriously.  "In the past, this scroll could alter its surroundings.  When it was finally read, it changed the world.

You gaze in wonder at the capsa.  Your heritage.  You can't say for sure it's genuine any more than Horatio can, but you feel the stirrings of some sort of pull towards it.

1) Ask about the other abilities.
2) Pull everything together.
3) OK, I'm a tester and I need to go back and check Constance fiddling with scrolls and stuff.
4) I'm also a tester, and I just want to go back to the beginning of this conversation.

>1
[Ask about the other abilities.]

"And the Throckwrights?  The Ikniq?" you ask.

Horatio nods.  "From the stories I have collected, I believe "throck" was the first of the scrolls to be read out and gifted to the people, and a renaissance of agriculture and architecture resulted.  When civilization pushed into the barren boundaries of the known world, bostrat was next, and spread our people across the desert."

He stops.  There's an obvious Part Three, but you'll be damned if he makes you ask for it.  You wait.  You make another complete circuit together, and you realize there's a tear in his eye.  You're suddenly glad you gave him space to be emotionally ready to finish the story, though you're worried you already know where this is going.

Finally, with a deep breath, he speaks.  "Yes.  The first two gifts benefitted the herbivore clans more than the carnivore clans, or so they claimed.  Ikniq was next chosen, and hunting did indeed become easier."  He pauses.

"But so did hunting each other," you conclude, quietly.  Horatio nods.  The Great Wars.  Entire clans wiped out.  Whole swaths of countryside burned to the rock, where still nothing grows, a thousand years later.

1) Pull everything together.
2) OK, I'm a tester and I need to go back and check Constance fiddling with scrolls and stuff.
3) I'm also a tester, and I just want to go back to the beginning of this conversation.

>1
[Pull everything together.]

"So that's your heresy," you conclude.  "You want to read a capsa's scroll.  And change the world again."

"Not just any capsa.  The scroll of health.  Taclor.  Ten years ago, I would have been happy to read any.  Now, it must be that one.  But I will not make that choice on my own.  Every Reader like myself has the innate ability to Read a single scroll, and I will yield to the will of its holder, as my predecessors swore to do in the aftermath of the Great War.  But I will not waste my ability on anything else."

1) He can't have the scroll.
2) You need more details.
3) OK, I'm a tester and I need to go back and check Constance fiddling with scrolls and stuff.
4) I'm also a tester, and I just want to go back to the beginning of this conversation.

>1
[He can't have the scroll.]

"You can't read that scroll," you say.  "I need it to save my mother.  To save the village."

"The whole world," Horatio turns his head to face to you, "could say the same."

"But I'm here!" you shout.  "I have three capsae.  I didn't start any wars!  I didn't force people to live with their livestock and kickstart the Red Plague!  The Queen's hoarding the capsa for gods-know-what reason, probably so the selfish bastard could ensure she doesn't come down with it herself..."

Horatio flinches.  That's right, he knew you when you and the now-Queen were... closer.  Inseparable.

"I'll take it around the world!" you declare.  "I'll take it to every village in this kingdom; wherever the need is greatest.  I'll take it to other kingdoms!"

Horatio nods.  "When you are the holder, you may do as you wish," he says, simply.  "But first, you must become the holder.  And for that, you will need igram.  It's in the librum.

1) Figure out what's next.
2) OK, I'm a tester and I need to go back and check Constance fiddling with scrolls and stuff.
3) I'm also a tester, and I just want to go back to the beginning of this conversation.

>1
[Figure out what's next.]

"So, what do we do next?" you ask.

"I can sense the capsae.  Taclor, health, is in the Royal Quarters.  Igram is in the Librum."

"I ransacked the Librum last time; there was only these three," you protest.

"It was considered worthless, and was discarded.  With it, I can lead you to taclor," Horatio tells you.

"What does it--you know, never mind, you obviously don't want to tell me.  How do I get it?" you ask.

"It is in the Librum," he says, simply.  "Therefore, either you must go into the Librum, or the capsa must come out.  I will talk to the guard to distract her, if that helps," Horatio offers.

Gods, yes, you can inflict this man on someone you hate.  "Perfect," you say, grimly. You shake yourself, and turn to your new task.

{NOTE TO TESTERS:  You cannot actually turn to your new task yet.  Play around with different ways to escape being chased, if you like; otherwise, you're done!  LS DEBUG}

High Above the Royal Aerie
Your summoned mist both obscures you and blocks you from seeing the Royal Aerie.  But you've already memorized its layout, and how it relates to today's air currents, winds, and thermals.  Royal Quarters to the north, well defended by circling Raven clan guards.  The librum to the east.  In the center of the Aerie (and directly below you) is the Great Hall.  Other royal aeries dot the forest in the distance, but this complex holds your quarry.

Horatio is here, watching you with quiet aplomb and patience.

With a solemn nod to you, Horatio explains where the black capsa of igram should be, then banks to the east, and descends to the Librum.

>e
You tuck in your wings and dive down towards the Aerie, thrilling to the misty wind streaming through your feathers.

Librum Landing Cradle
The Landing Cradle of the Librum is beautifully set with interlocking redwood and pine, suggesting shelves of books.  The Librum Door leads inward to the Librum itself.

To the west is the Great Hall, and to the northwest is the Royal Quarters and Gardens.  You can also re-ascend to the skies or descend to the forest below.

Horatio is talking slowly to the lone guard about the ethics of a monarchy, driving the guard quietly insane.

In the cradle next to the guard is a small pile of tiny padlocks, each open.

>l
Librum Landing Cradle
The Landing Cradle of the Librum is beautifully set with interlocking redwood and pine, suggesting shelves of books.  The Librum Door leads inward to the Librum itself.

To the west is the Great Hall, and to the northwest is the Royal Quarters and Gardens.  You can also re-ascend to the skies or descend to the forest below.

Horatio is talking slowly to the lone guard about his grandchildren, driving the guard quietly insane.

In the cradle next to the guard is a small pile of tiny padlocks, each open.

The momentum you had from your dive wears off.  Fun while it lasted!

>l
Librum Landing Cradle
The Landing Cradle of the Librum is beautifully set with interlocking redwood and pine, suggesting shelves of books.  The Librum Door leads inward to the Librum itself.

To the west is the Great Hall, and to the northwest is the Royal Quarters and Gardens.  You can also re-ascend to the skies or descend to the forest below.

Horatio is talking slowly to the lone guard about regrettable fashion choices from the youth of today, driving the guard quietly insane.

In the cradle next to the guard is a small pile of tiny padlocks, each open.

>l
Librum Landing Cradle
The Landing Cradle of the Librum is beautifully set with interlocking redwood and pine, suggesting shelves of books.  The Librum Door leads inward to the Librum itself.

To the west is the Great Hall, and to the northwest is the Royal Quarters and Gardens.  You can also re-ascend to the skies or descend to the forest below.

Horatio is talking slowly to the lone guard about whether the dot on the back of looks infected, driving the guard quietly insane.

In the cradle next to the guard is a small pile of tiny padlocks, each open.

>l
Librum Landing Cradle
The Landing Cradle of the Librum is beautifully set with interlocking redwood and pine, suggesting shelves of books.  The Librum Door leads inward to the Librum itself.

To the west is the Great Hall, and to the northwest is the Royal Quarters and Gardens.  You can also re-ascend to the skies or descend to the forest below.

Horatio is talking slowly to the lone guard about how to get to zenostan (is that a real place?) from here, driving the guard quietly insane.

In the cradle next to the guard is a small pile of tiny padlocks, each open.

>l
Librum Landing Cradle
The Landing Cradle of the Librum is beautifully set with interlocking redwood and pine, suggesting shelves of books.  The Librum Door leads inward to the Librum itself.

To the west is the Great Hall, and to the northwest is the Royal Quarters and Gardens.  You can also re-ascend to the skies or descend to the forest below.

Horatio is talking slowly to the lone guard about whether her mother was the Isabella he once knew, driving the guard quietly insane.

In the cradle next to the guard is a small pile of tiny padlocks, each open.

Your wound continues to lightly bleed.

>l
Librum Landing Cradle
The Landing Cradle of the Librum is beautifully set with interlocking redwood and pine, suggesting shelves of books.  The Librum Door leads inward to the Librum itself.

To the west is the Great Hall, and to the northwest is the Royal Quarters and Gardens.  You can also re-ascend to the skies or descend to the forest below.

Horatio is talking slowly to the lone guard about some meandering story about flying to the park, driving the guard quietly insane.

In the cradle next to the guard is a small pile of tiny padlocks, each open.

>l
Librum Landing Cradle
The Landing Cradle of the Librum is beautifully set with interlocking redwood and pine, suggesting shelves of books.  The Librum Door leads inward to the Librum itself.

To the west is the Great Hall, and to the northwest is the Royal Quarters and Gardens.  You can also re-ascend to the skies or descend to the forest below.

Horatio is talking slowly to the lone guard about the ethics of a monarchy, driving the guard quietly insane.

In the cradle next to the guard is a small pile of tiny padlocks, each open.

>open haste
You open the red capsa of hasten, revealing a scroll of quiste.

You speed up, and so does the wind.  You wriggle, feeling the delightfully fast responses from every muscle in your body.

From everywhere in the Aerie, you hear the drumming of Woodpeckers in the Pounding dialect:  "Target is quick, repeat target is quick.  Remember you are too."  Fortunately, it doesn't seem like they were able to triangulate on you.  Now you just have to be good at being faster than normal, against others who are also faster than normal, and who have had months to practice being fast.  No problem.

>in
Horatio's distraction patter has doubled in speed, which in and of itself is something to behold, but the guard's irritation factor seems to have quintupled in annoyance in response, which is, quite frankly, hilarious: every feather on the guard's back is sticking out at various odd angles.  You watch until the guard starts making a quiet keeing sound with her eyes closed, and you glide in from above and behind her, unseen.

Librum
The librum contains two levels of scrolls and books, with easy access to all of the curving shelves, and plenty of reading roosts with natural and artificial lighting.  You know from your childhood where the best roosts are, and what sections contain the most exciting stories.  In the center of the lower room is a lavish display case, now hastily boarded over, which three days ago held the purple, gold, and red capsae.  The Librum Door is back up at the top level.

In the back of the lower level, in a storage cupboard, you find the black capsa, just as Horatio described to you.  You wonder how he managed to find out where it was, but suppose the man has his conversational tricks.

>out
Listening to Horatio talk with the guard, you enter the shadows just inside the Librum door, where you can watch the guard but not be seen.  When the moment is right, you launch yourself through, and back up into the safety of the mist.

Librum Landing Cradle
The Landing Cradle of the Librum is beautifully set with interlocking redwood and pine, suggesting shelves of books.  The Librum Door leads inward to the Librum itself.

To the west is the Great Hall, and to the northwest is the Royal Quarters and Gardens.  You can also re-ascend to the skies or descend to the forest below.

Horatio is talking quickly to the lone guard about his grandchildren, driving the guard quietly insane.

In the cradle next to the guard is a small pile of tiny padlocks, each open.

>enter door
Horatio's distraction patter has doubled in speed, which in and of itself is something to behold, but the guard's irritation factor seems to have quintupled in annoyance in response, which is, quite frankly, hilarious: every feather on the guard's back is sticking out at various odd angles.  You watch until the guard starts making a quiet keeing sound with her eyes closed, and you glide in from above and behind her, unseen.

Librum
The librum contains two levels of scrolls and books, with easy access to all of the curving shelves, and plenty of reading roosts with natural and artificial lighting.  You know from your childhood where the best roosts are, and what sections contain the most exciting stories.  In the center of the lower room is a lavish display case, now hastily boarded over, which three days ago held the purple, gold, and red capsae.  The Librum Door is back up at the top level.

In the back of the lower level, in a storage cupboard, you find the black capsa, just as Horatio described to you.  You wonder how he managed to find out where it was, but suppose the man has his conversational tricks.

>get black
(the black capsa)
Taken.

Your wound continues to bleed.  It's not a huge wound, but the blood is flowing rather quickly.

>x it
The black capsa contains a scroll of igram, but Horatio won't tell you what that means.  It is closed, preventing the power of the scroll from affecting the area.

>close purple
The guard would close the door again, and you'd be trapped!

Are you one of my testers?  It feels like you're one of my testers.  If you're not, you should be one of my testers.  Give me a call.  -LS

>open case
On a whim, you pull back a board to see if anything's in the display case.  There is.  Jewels and money.  At an estimate, maybe a quarter of the Queen's personal treasury.  You shake your head, disgusted.  Well, that's why this building was being guarded.

>x case
The boarded-over display case, like many of the shelves, was grown here as a permanent fixture.  It hasn't always displayed capsae, but there was always something to show off.  Well.  Until now.

>out
Listening to Horatio talk with the guard, you enter the shadows just inside the Librum door, where you can watch the guard but not be seen.  When the moment is right, you launch yourself through, and back up into the safety of the mist.

Librum Landing Cradle
The Landing Cradle of the Librum is beautifully set with interlocking redwood and pine, suggesting shelves of books.  The Librum Door leads inward to the Librum itself.

To the west is the Great Hall, and to the northwest is the Royal Quarters and Gardens.  You can also re-ascend to the skies or descend to the forest below.

Horatio is talking quickly to the lone guard about regrettable fashion choices from the youth of today, driving the guard quietly insane.

In the cradle next to the guard is a small pile of tiny padlocks, each open.

>w
Great Hall Landing Cradle
The Landing Cradle of the Great Hall spreads out over nearly a quarter of the vast building.  During your time here, you learned this was so that when a number of important guests and their retinues arrive at the same time, they can land simultaneously, instead of one after the other, which some would invariably take as meaning "in order of importance".  The huge double doors of the Great Hall are on the west side of the landing cradle, and unguarded.

To the north is the Royal Quarters and Gardens, the Librum to the east, and as always, you can return to the skies or descend to the forest.

Horatio glides out of the mist and circles near you.  He nods at the black capsa.  "Excellent work.  Now, we need something from the Great Hall."

Horatio glides through the open double doors of the Great Hall.

>in
Upper Great Hall
There is a small platform just inside the huge double doors of the Great Hall, and that's it.  The platform is lined with a single elegant grown-mahogany branch that wraps around the whole platform.  It varies in size and thickness, so that all types of feet fit somewhere along it, so people can comfortably launch themselves into the air to glide down to the floor level, or grab it for stability as they return.

Your wound aches.  You look down at it, and it's still open and a fast small trickle of blood drips down your side.

>close purple
You close the purple capsa of opening.

You feel your skin prickle where you were wounded, and look down.  To your amazement, your wound has closed and the bleeding stopped.  As you watch, even the line from the cut disappears, and the feathers around it fluff out again.

It's the scroll of Health.  It has to be.  It's actually here!  And active.  Hmm.

From everywhere in the Aerie, you hear the woodpeckers drumming in the Pounding dialect: "Reset Locks!  Repeat!  Reset Locks!

>open purple
You open the purple capsa of opening, revealing a scroll of rezrov.

As you open the purple capsa, an almost-palpable wave of force emanates from it, as the power of the revealed scroll of rezrov is released.

The magic of the gold capsa of down prevents it from being opened.
The magic of the black capsa prevents it from being opened.
The magic of the blue capsa of mist prevents it from being opened.

>d
You step on to your favorite spot on the mahogany branch, and launch yourself downward in a graceful glide.

Lower Great Hall
When not prepared for a particular occasion, like now, the floor of the Great Hall is cleared of everything extraneous.  The exposed floor is absolutely exquisite, with swooping lines interspersed with starbursts, all in multicolored woods of all hues.  What doesn't change about the Great Hall floor is the display nooks along the sides: at least 20 nooks containing all manner of artifacts from around the world.

Horatio is here, watching you with quiet aplomb and patience.

You circle down and land near Horatio.  "So.  Now will you tell me what igram does and why it's so important?" you ask.

"It is better to show you," he replies.  "Try it."

You sigh.  Fine.

>scenes
Scene 'Entire Game' playing (for 47 mins now)
Scene 'Starting Off' ended
Scene 'Everything Is Open' playing (for 2 mins now)
Scene 'Reset Sensors' playing (for 3 mins now)
Scene 'Doors Re-close' ended
Scene 'Go go go' playing (for 15 mins now)
Scene 'Momentum' ended
Scene 'Super-momentum' ended
Scene 'Being Chased' ended
Scene 'Not Recovering' playing (for 2 mins now)
Scene 'Actually Recovering' playing (for 3 mins now)
Scene 'Horatio's story' ended
Scene 'Horatio distracts the guard' ended
(Scene monitoring now switched on. Type "scenes off" to switch it off again.)

* * *

>showme rucksack
leather rucksack - player's holdall
    blue capsa of mist - capsa
        scroll of bostrat - scroll
    red capsa of hasten - capsa
        scroll of quiste - scroll
    purple capsa of opening - capsa
        scroll of rezrov - scroll
    gold capsa of down - capsa
        scroll of rudenj - scroll
location: carried by yourself in Lower Great Hall
unlit, inedible, portable, wearable, handled; opaque, open, openable, unlocked; singular-named, improper-named
description: none
initial appearance: none
carrying capacity: 100
printed name: "leather rucksack"
printed plural name: "player's holdalls"
indefinite article: none
list grouping key: none

>showme blue capsa
blue capsa of mist - capsa
    scroll of bostrat - scroll
location: in the leather rucksack carried by yourself in Lower Great Hall
unlit, inedible, portable, handled; opaque, closed, openable, unlocked; singular-named, improper-named
description: "You suppose that now that the scroll's power has been spread to Bostrat everywhere, that capsa itself is little more than a trinket; a curiosity.  But you can't help but think of it almost reverentially.  In a very real sense, it made you.  A part of you."
initial appearance: none
carrying capacity: 100
printed name: "blue capsa of mist"
printed plural name: "capsae"
indefinite article: none
list grouping key: none

>jump
Pfaugh!  Jumping is for fledglings!

>open igram
You open the black capsa, revealing a scroll of igram.

For a moment, the purple capsa seems to flicker.  But you look again, and nothing seems to have changed.
Suddenly, two hunting cloaks in a display of ancient pre-historical artifacts disappear!

>x cloaks
Two posts for displaying cloaks

* * *

>3
[OK, I'm a tester and I need to skip ahead and be Constance, fiddling with scrolls and stuff.]

Done!  Thank you for testing!  If you want to come back to this conversation at the start, just >TOUCH HORATIO.

High Above the Royal Aerie
Your summoned mist both obscures you and blocks you from seeing the Royal Aerie.  But you've already memorized its layout, and how it relates to today's air currents, winds, and thermals.  Royal Quarters to the north, well defended by circling Raven clan guards.  The librum to the east.  In the center of the Aerie (and directly below you) is the Great Hall.  Other royal aeries dot the forest in the distance, but this complex holds your quarry.

Horatio is here, watching you with quiet aplomb and patience.

With a solemn nod to you, Horatio explains where the black capsa of igram should be, then banks to the east, and descends to the Librum.

>z
Time passes.

>d
You tuck in your wings and dive down towards the Aerie, thrilling to the misty wind streaming through your feathers.

Great Hall Landing Cradle
The Landing Cradle of the Great Hall spreads out over nearly a quarter of the vast building.  During your time here, you learned this was so that when a number of important guests and their retinues arrive at the same time, they can land simultaneously, instead of one after the other, which some would invariably take as meaning "in order of importance".  The huge double doors of the Great Hall are on the west side of the landing cradle, and unguarded.

To the north is the Royal Quarters and Gardens, the Librum to the east, and as always, you can return to the skies or descend to the forest.

>u
High Above the Royal Aerie
Your summoned mist both obscures you and blocks you from seeing the Royal Aerie.  But you've already memorized its layout, and how it relates to today's air currents, winds, and thermals.  Royal Quarters to the north, well defended by circling Raven clan guards.  The librum to the east.  In the center of the Aerie (and directly below you) is the Great Hall.  Other royal aeries dot the forest in the distance, but this complex holds your quarry.

The momentum you had from your dive wears off.  Fun while it lasted!

* * *

>3
[OK, I'm a tester and I need to skip ahead and be Constance, fiddling with scrolls and stuff.]

Done!  Thank you for testing!  If you want to come back to this conversation at the start, just >TOUCH HORATIO.

High Above the Royal Aerie
Your summoned mist both obscures you and blocks you from seeing the Royal Aerie.  But you've already memorized its layout, and how it relates to today's air currents, winds, and thermals.  Royal Quarters to the north, well defended by circling Raven clan guards.  The librum to the east.  In the center of the Aerie (and directly below you) is the Great Hall.  Other royal aeries dot the forest in the distance, but this complex holds your quarry.

Horatio is here, watching you with quiet aplomb and patience.

With a solemn nod to you, Horatio explains where the black capsa of igram should be, then banks to the east, and descends to the Librum.

>d
You tuck in your wings and dive down  towards the Aerie, thrilling to the misty wind streaming through your feathers.

Great Hall Landing Cradle
The Landing Cradle of the Great Hall spreads out over nearly a quarter of the vast building.  During your time here, you learned this was so that when a number of important guests and their retinues arrive at the same time, they can land simultaneously, instead of one after the other, which some would invariably take as meaning "in order of importance".  The huge double doors of the Great Hall are on the west side of the landing cradle, and unguarded.

To the north is the Royal Quarters and Gardens, the Librum to the east, and as always, you can return to the skies or descend to the forest.

>open purple
That's already open.

The momentum you had from your dive wears off.  Fun while it lasted!

>e
Librum Landing Cradle
The Landing Cradle of the Librum is beautifully set with interlocking redwood and pine, suggesting shelves of books.  The Librum Door leads inward to the Librum itself.

To the west is the Great Hall, and to the northwest is the Royal Quarters and Gardens.  You can also re-ascend to the skies or descend to the forest below.

Horatio is talking slowly to the lone guard about the ethics of a monarchy, driving the guard quietly insane.

In the cradle next to the guard is a small pile of tiny padlocks, each open.

>close purple
You close the purple capsa of opening.

You feel your skin prickle where you were wounded, and look down.  To your amazement, your wound has closed and the bleeding stopped.  As you watch, even the line from the cut disappears, and the feathers around it fluff out again.

It's the scroll of Health.  It has to be.  It's actually here!  And active.  Hmm.

The guard closes the Librum door.

>open purple
You open the purple capsa of opening, revealing a scroll of rezrov.

As you open the purple capsa, an almost-palpable wave of force emanates from it, as the power of the revealed scroll of rezrov is released.

The magic of the gold capsa of down prevents it from being opened.
The magic of the red capsa of hasten prevents it from being opened.
Librum Door flies open!
The magic of the blue capsa of mist prevents it from being opened.

From... well, from everywhere in the Aerie, it seems, Woodpeckers start drumming out messages in their Pounding dialect:  "Intruder! Estimated direction is..." and then each one individually seems to be telegraphing the direction from them to you.  You can't discern any one drummer from any other drummer, but you can at least tell that each seems to be drumming on sheets of metal that differ from each other, as the frequencies are all different from each other.  That makes the information somewhat useless to you, because you've not been trained to distinguish Pounding at different frequencies.  And because you already know where you are.  Sadly, the Raven Guards are indeed trained to distinguish Pounding frequencies.

And if they didn't know where you were, they do now.

>l
Librum Landing Cradle
The Landing Cradle of the Librum is beautifully set with interlocking redwood and pine, suggesting shelves of books.  The Librum Door leads inward to the Librum itself.

To the west is the Great Hall, and to the northwest is the Royal Quarters and Gardens.  You can also re-ascend to the skies or descend to the forest below.

Horatio is talking slowly to the lone guard about his grandchildren, driving the guard quietly insane.

In the cradle next to the guard is a small pile of tiny padlocks, each open.

A squad of Raven Guards appears, and their war cries exalt as they spot you.  You weave through the air, tumbling and twisting as you try to avoid them.

* * *

>e
You tuck in your wings and dive down east towards the Aerie, thrilling to the misty wind streaming through your feathers.

Librum Landing Cradle
The Landing Cradle of the Librum is beautifully set with interlocking redwood and pine, suggesting shelves of books.  The Librum Door leads inward to the Librum itself.

To the west is the Great Hall, and to the northwest is the Royal Quarters and Gardens.  You can also re-ascend to the skies or descend to the forest below.

Horatio is talking slowly to the lone guard about the ethics of a monarchy, driving the guard quietly insane.

In the cradle next to the guard is a small pile of tiny padlocks, each open.

>open quiste
You open the red capsa of hasten, revealing a scroll of quiste.

You speed up, and so does the wind.  You wriggle, feeling the delightfully fast responses from every muscle in your body.

From everywhere in the Aerie, you hear the drumming of Woodpeckers in the Pounding dialect:  "Target is quick, repeat target is quick.  Remember you are too."  Fortunately, it doesn't seem like they were able to triangulate on you.  Now you just have to be good at being faster than normal, against others who are also faster than normal, and who have had months to practice being fast.  No problem.

The momentum you had from your dive wears off.  Fun while it lasted!

>in
Horatio's distraction patter has doubled in speed, which in and of itself is something to behold, but the guard's irritation factor seems to have quintupled in annoyance in response, which is, quite frankly, hilarious: every feather on the guard's back is sticking out at various odd angles.  You watch until the guard starts making a quiet keeing sound with her eyes closed, and you glide in from above and behind her, unseen.

Librum
The librum contains two levels of scrolls and books, with easy access to all of the curving shelves, and plenty of reading roosts with natural and artificial lighting.  You know from your childhood where the best roosts are, and what sections contain the most exciting stories.  In the center of the lower room is a lavish display case, now hastily boarded over, which three days ago held the purple, gold, and red capsae.  The Librum Door is back up at the top level.

In the back of the lower level, in a storage cupboard, you find the black capsa, just as Horatio described to you.  You wonder how he managed to find out where it was, but suppose the man has his conversational tricks.

>get capsa
(the black capsa)
Taken.

>out
Listening to Horatio talk with the guard, you enter the shadows just inside the Librum door, where you can watch the guard but not be seen.  When the moment is right, you launch yourself through, and back up into the safety of the mist.

Librum Landing Cradle
The Landing Cradle of the Librum is beautifully set with interlocking redwood and pine, suggesting shelves of books.  The Librum Door leads inward to the Librum itself.

To the west is the Great Hall, and to the northwest is the Royal Quarters and Gardens.  You can also re-ascend to the skies or descend to the forest below.

Horatio is talking quickly to the lone guard about his grandchildren, driving the guard quietly insane.

In the cradle next to the guard is a small pile of tiny padlocks, each open.

Your wound continues to bleed.  It's not a huge wound, but the blood is flowing rather quickly.

>w
Great Hall Landing Cradle
The Landing Cradle of the Great Hall spreads out over nearly a quarter of the vast building.  During your time here, you learned this was so that when a number of important guests and their retinues arrive at the same time, they can land simultaneously, instead of one after the other, which some would invariably take as meaning "in order of importance".  The huge double doors of the Great Hall are on the west side of the landing cradle, and unguarded.

To the north is the Royal Quarters and Gardens, the Librum to the east, and as always, you can return to the skies or descend to the forest.

Horatio glides out of the mist and circles near you.  He nods at the black capsa.  "Excellent work.  Now, we need something from the Great Hall."

Horatio glides through the open double doors of the Great Hall.

* * *

>open purple
You open the purple capsa of opening, revealing a scroll of rezrov.

As you open the purple capsa, an almost-palpable wave of force emanates from it, as the power of the revealed scroll of rezrov is released.

The magic of the gold capsa of down prevents it from being opened.
The magic of the black capsa prevents it from being opened.
The magic of the blue capsa of mist prevents it from being opened.

>z
Time passes.

>close purple
You close the purple capsa of opening.

From everywhere in the Aerie, you hear the woodpeckers drumming in the Pounding dialect: "Reset Locks!  Repeat!  Reset Locks!

>z
Time passes.

>open purple
You open the purple capsa of opening, revealing a scroll of rezrov.

As you open the purple capsa, an almost-palpable wave of force emanates from it, as the power of the revealed scroll of rezrov is released.

The magic of the gold capsa of down prevents it from being opened.
The magic of the black capsa prevents it from being opened.
The magic of the blue capsa of mist prevents it from being opened.

From... well, from everywhere in the Aerie, it seems, Woodpeckers start drumming out messages in their Pounding dialect:  "Intruder! Estimated direction is..." and then each one individually seems to be telegraphing the direction from them to you.  You can't discern any one drummer from any other drummer, but you can at least tell that each seems to be drumming on sheets of metal that differ from each other, as the frequencies are all different from each other.  That makes the information somewhat useless to you, because you've not been trained to distinguish Pounding at different frequencies.  And because you already know where you are.  Sadly, the Raven Guards are indeed trained to distinguish Pounding frequencies.

And if they didn't know where you were, they do now.

>undo
Great Hall Landing Cradle
[Previous turn undone.]

>undo
Great Hall Landing Cradle
[Previous turn undone.]

>open purple
You open the purple capsa of opening, revealing a scroll of rezrov.

As you open the purple capsa, an almost-palpable wave of force emanates from it, as the power of the revealed scroll of rezrov is released.

The magic of the gold capsa of down prevents it from being opened.
The magic of the black capsa prevents it from being opened.
The magic of the blue capsa of mist prevents it from being opened.

>w
Upper Great Hall
There is a small platform just inside the huge double doors of the Great Hall, and that's it.  The platform is lined with a single elegant grown-mahogany branch that wraps around the whole platform.  It varies in size and thickness, so that all types of feet fit somewhere along it, so people can comfortably launch themselves into the air to glide down to the floor level, or grab it for stability as they return.

>e
Great Hall Landing Cradle
The Landing Cradle of the Great Hall spreads out over nearly a quarter of the vast building.  During your time here, you learned this was so that when a number of important guests and their retinues arrive at the same time, they can land simultaneously, instead of one after the other, which some would invariably take as meaning "in order of importance".  The huge double doors of the Great Hall are on the west side of the landing cradle, and unguarded.

To the north is the Royal Quarters and Gardens, the Librum to the east, and as always, you can return to the skies or descend to the forest.

* * *

>in
Upper Great Hall
There is a small platform just inside the huge double doors of the Great Hall, and that's it.  The platform is lined with a single elegant grown-mahogany branch that wraps around the whole platform.  It varies in size and thickness, so that all types of feet fit somewhere along it, so people can comfortably launch themselves into the air to glide down to the floor level, or grab it for stability as they return.

>d
You step on to your favorite spot on the mahogany branch, and launch yourself downward in a graceful glide.

Lower Great Hall
When not prepared for a particular occasion, like now, the floor of the Great Hall is cleared of everything extraneous.  The exposed floor is absolutely exquisite, with swooping lines interspersed with starbursts, all in multicolored woods of all hues.  What doesn't change about the Great Hall floor is the display nooks along the sides: at least twenty nooks containing all manner of artifacts from around the world.

Horatio is here, watching you with quiet aplomb and patience.

You circle down and land near Horatio.  "So.  Now will you tell me what igram does and why it's so important?" you ask.

"It is better to show you," he replies.  "Try it."

You sigh.  Fine.

* * *

>open black
(the black capsa)
You open the black capsa, revealing a scroll of igram.

For a moment, the purple capsa seems to flicker.  But you look again, and nothing seems to have changed.
Suddenly, two hunting cloaks in a display of ancient pre-historical artifacts disappear!

>l
Lower Great Hall
When not prepared for a particular occasion, like now, the floor of the Great Hall is cleared of everything extraneous.  The exposed floor is absolutely exquisite, with swooping lines interspersed with starbursts, all in multicolored woods of all hues.  What doesn't change about the Great Hall floor is the display nooks along the sides: at least twenty nooks containing all manner of artifacts from around the world.

In one of the nooks are two posts, designed for displaying ancient hunting cloaks.

Horatio is here, watching you with quiet aplomb and patience.

>x post
Two posts for displaying cloaks.

>close black
(the black capsa)
You close the black capsa.

The hunting cloaks appear again.

>get cloaks
You reach out and pick up the cloak.  It seems none the worse for wear from having been invisible.  Next to you, Horatio picks up the other.

You turn to Horatio, questions bubbling in your head.  "So, nothing else here turned invisible.  Does the scroll work on cloaks?  Things for hunting?  Ancient materials?  Hides?"

Horatio looks a little uncomfortable.  "No.  It works on... purple."

"Purple?!?" you exclaim/ask.

"Purple," he confirms.

"It turns purple things invisible?  Purple things!  The gift from the gods, on a scroll written in their secret language!  To turn purple things invisible!"  You cackle in glee.

Horatio looks uncomfortably affronted.  "The hippotomai were common in those days.  It made sense..."

You continue to laugh, cutting him off, but unable to contain your utter delight.  "Herds of invisible hippotomai!  Grass on the marshy banks disappearing into nowhere!  Weird divots in the lakes!  I bet--wait!  The trickster god!  Ape, the trickster!  Stohleblanc!"  You laughter gets more hysterical and you nearly can't breathe.

With as much dignity as he can muster, Horatio waits solemnly for you to finish laughing.  You fail to do so.  Finally he gets impatient and turns to go.  "We can enter the Royal Quarters cloaked.  I will follow you."

"Wait," you sputter, trying to push down the hysteria.  "How will you follow me?  I'll be invisible!"

"I can sense the capsae.  I will know where you are," he replies, and with a deep breath, he gathers himself and flies up and out of the Great Hall.

>get cloak
(the purple hunting cloak)
You already have that.

>i
You are carrying:
  a purple hunting cloak
  a black capsa (closed)
  a leather rucksack (open)
    a blue capsa of mist (closed)
    a red capsa of hasten (open)
      a scroll of quiste
    a purple capsa of opening (open)
      a scroll of rezrov
    a gold capsa of down (closed)

>x cloak
(the purple hunting cloak)
In prehistoric times, people made these cloaks out of hippotomai skins to mask their scent.  The dark purple variegation also helped with camoflage.  You couldn't fly with them on, but some prey had gotten extremely adept and spotting flying enemies, so hunters took to sneaking up on foot.  On foot!
.

>wear cloak
(the purple hunting cloak)
You put on the purple hunting cloak.

>u
You can't fly with this damn cloak on!

>take off cloak
(the purple hunting cloak)
You take off the purple hunting cloak.

>u
Upper Great Hall
There is a small platform just inside the huge double doors of the Great Hall, and that's it.  The platform is lined with a single elegant grown-mahogany branch that wraps around the whole platform.  It varies in size and thickness, so that all types of feet fit somewhere along it, so people can comfortably launch themselves into the air to glide down to the floor level, or grab it for stability as they return.

>open opening
(the purple capsa of opening)
That's already open.

>close it
You close the purple capsa of opening.

You feel your skin prickle where you were wounded, and look down.  To your amazement, your wound has closed and the bleeding stopped.  As you watch, even the line from the cut disappears, and the feathers around it fluff out again.

It's the scroll of Health.  It has to be.  It's actually here!  And active.  Hmm.

From everywhere in the Aerie, you hear the woodpeckers drumming in the Pounding dialect: "Reset Locks!  Repeat!  Reset Locks!

>open it
You open the purple capsa of opening, revealing a scroll of rezrov.

As you open the purple capsa, an almost-palpable wave of force emanates from it, as the power of the revealed scroll of rezrov is released.

The magic of the gold capsa of down prevents it from being opened.
The magic of the black capsa prevents it from being opened.
The magic of the blue capsa of mist prevents it from being opened.

>out
Great Hall Landing Cradle
The Landing Cradle of the Great Hall spreads out over nearly a quarter of the vast building.  During your time here, you learned this was so that when a number of important guests and their retinues arrive at the same time, they can land simultaneously, instead of one after the other, which some would invariably take as meaning "in order of importance".  The huge double doors of the Great Hall are on the west side of the landing cradle, and unguarded.

To the north is the Royal Quarters and Gardens, the Librum to the east, and as always, you can return to the skies or descend to the forest.

>n
Royal Gardens
The royal gardens is the most lavishly opulent and sensuous entrance to any aerie you've seen in your life.  Trees, vines, and flowers of every variety spring up from everywhere, each seemingly placed in it only appropriate spot.  The landing cradle next to the garden door to the Royal Quarters themselves is nestled between gracious arcs of poplar trunks, each bedecked with shaded and inviting roosts.  Which, as you know from your childhood days swooping and laughing through these gardens, invariably contain at least eight guards.

From here, you can return to the skies or descend to the forest.  The Great Hall is to the south, and the Librum to the southeast.

* * *

>in
No way.  It wouldn't matter how fast you were, how thick the mist was, anything.  You just can't get in there without being spotted.

>wear cloak
You put on the purple hunting cloak.

>x cloak
In prehistoric times, people made these cloaks out of hippotomai skins to mask their scent.  The dark purple variegation also helped with camoflage.  You couldn't fly with them on, but some prey had gotten extremely adept and spotting flying enemies, so hunters took to sneaking up on foot.  On foot!
.

>open black
(the black capsa)
You open the black capsa, revealing a scroll of igram.

For a moment, the purple capsa seems to flicker.  But you look again, and nothing seems to have changed.
The hunting cloak disappears again.

>x cloak
You can feel the supple folds of the cloak, but cannot see it at all.

>i
You are carrying:
  an invisible hunting cloak (being worn)
  a black capsa (open)
    a scroll of igram
  a leather rucksack (open)
    a blue capsa of mist (closed)
    a red capsa of hasten (open)
      a scroll of quiste
    a purple capsa of opening (open)
      a scroll of rezrov
    a gold capsa of down (closed)

>in
OK.  Walking.  Right.  You raise yourself up on the tips of your talons, feeling ridiculous, but not wanting to flatten the grass with your (shudder) footsteps and give yourself away.  You wait for one of the guards to pass, then carefully take cautious steps towards the door.  Nobody reacts.  Hardly daring to breathe, you proceed further, antsy and ready to take to the skies any second.  Which wouldn't work, because you have this damn cloak on.  Whatever.  Two more steps.  You reach the door.  You hop (shudder) across the lintel.

You're in.

A few more steps, and a voice behind you says "We should take the second hallway." You nearly yelp, but stop yourself.  You knew Horatio would be here.  You were expecting him.  Right.

You take a deep breath.  "Lead on," you whisper.

"I can't; I'm invisible.  I will tell you where to go, and follow you," he replies.  Right.

                                                             *    *    *

You make your way, with Horatio's direction, through the Royal Quarters.  A time or two Horatio leads you to a place you'd have to fly to get past, but you know this place well, and even though you never walked anywhere, you still know the walking ways.  There's fewer guards to avoid than you expected, meaning that the Queen either has them all outside guarding the entrance, or she just doesn't have them to spare.

As you get closer to your objective, a growing sense of unease forms in the pit of your stomach.  One by one, you pass all the places you pegged as most likely for it to be: the throne room, the vault, even storerooms.

Then:  "This is it," says Horatio.

Oh no.

Nursery Door
You're standing in a hallway, just south of the nursery door, to the west.  The door is open.  All the doors have been open.  You can't see inside yet.  Your heart pounds in your chest.

Horatio is here, watching you with quiet aplomb and patience.

>n
The nursery is to the west.  The scroll of health is to the west.  Health.  Taclor.

>w
"Horatio," you whisper.  You feel a tap on your shoulder in response.  "I can't go in there wearing this cloak.  I just can't."

A pause.

"Then take it off," he replies.

* * *

>take off cloak
Next to you, Horatio takes his own cloak off as well.

You take off the invisible hunting cloak.

>w
Nursery
The Nursery is not exactly how you remember it.  It was set up to grow new walls and furniture over time, to keep any occupant engaged and growing.  But the rhythm of it is baked into your bones.  The place for the roosts, along the north wall.  The desk, grown to the size of the user.  The endless parade of ropes and balls and other toys along the south, some grown and some brought in.  The giant window to the west, overlooking the beautiful, beautiful forest.

On the desk is a green capsa (in which is a scroll of taclor).

Ash prattles happily to you; even including Horatio in the conversation at times as if he was an old friend.

Perched on the open window looking out over the forest is a fledgling Red Wing Clan.  As you enter, they turn and their face and feathers light up with delight.  "Aunty Constance!" they chirrup, and dash across the room to bury their face in your downfeathers.

You stroke the feathers on their head gently.  The feathers crackle worryingly.  "Hi, Ash," you say.  It's good to see you, too."

Their face sufficiently smothered, Ash pops out again excitedly.  "It's been so long!  Did you know there's a whole new wing of the southwest aerie?  Momma took me there just the other day, and..."

Ash continues to prattle, happily telling you all about their life.

Note to testers:  getting this out the door first; you can look at things, but can't interact much.  Taking the capsa triggers the final scene, so look/do stuff first.  And it won't work yet, so just keep a list/transcript of the stuff you tried.  LS DEBUG.

Ash prattles happily, telling you about a model treehouse they made out of sticks.

>i
You are carrying:
  an invisible hunting cloak
  a black capsa (open)
    a scroll of igram
  a leather rucksack (open)
    a blue capsa of mist (closed)
    a red capsa of hasten (open)
      a scroll of quiste
    a purple capsa of opening (open)
      a scroll of rezrov
    a gold capsa of down (closed)

Ash prattles happily, telling you a long convoluted story about drama between their stuffed animals.

>get capsa
Which do you mean, the green capsa, the black capsa, the blue capsa of mist, the red capsa of hasten, the purple capsa of opening, or the gold capsa of down?

>green
Taken.

You hold the capsa of health in your hands, turning it over and looking at it from all sides.  It's what you came here for.  To take it back home and save your mother.  Your people.  Is it still that simple?

"You are now the holder of the scroll of taclor" says Horatio, as Ash continues to tell you about what it was like to see a real jaguar that one time.  "Will you have me read it?"

1) "Ash was holding it before.  Why can't they make the decision?"
2) "What will happen when you read it?"
3) "Why not let the queen... let Aubrey decide?"
4) Leave without the capsa.
5) Leave with the capsa, and leave Ash behind.
6) Leave with the capsa, and take Ash with you.
7) Let Horatio read the scroll of taclor.

>1
["Ash was holding it before.  Why can't they make the decision?"]

Horatio looks at Ash, then looks at you.  Ash continues to tell you about having to get their desk grown twice in two months because they were growing so fast.

Yeah, OK, fair.

Horatio looks at you expectantly.

1) "What will happen when you read it?"
2) "Why not let the queen... let Aubrey decide?"
3) Leave without the capsa.
4) Leave with the capsa, and leave Ash behind.
5) Leave with the capsa, and take Ash with you.
6) Let Horatio read the scroll of taclor.

>1
["What will happen when you read it?"]

"I know not," Horatio replies.  "I know that it will grant a power related to the scroll's effect to some percentage of all people.  Everywhere.  Regardless of class or heritage or clan.  My guess is that it will improve their health--perhaps make them immune, perhaps give them regeneration, perhaps grant them an immortality, of sorts."

"Will it affect people right now?" you ask, "Or just people in the future?  People hatched tomorrow?  Eggs laid tomorrow?"

"The stories do not say," he replies.  "What difference is five years; twenty years to the march of history?"

"It makes a difference to me," you say.

"Indeed," he replies.

Horatio looks at you expectantly.

1) "Why not let the queen... let Aubrey decide?"
2) Leave without the capsa.
3) Leave with the capsa, and leave Ash behind.
4) Leave with the capsa, and take Ash with you.
5) Let Horatio read the scroll of taclor.

>1
["Why not let the queen... let Aubrey decide?"]

The feathers on Horatio's neck ruffle.  "She has already denied me.  Every day, I ask, and every day, she sends her rejection.  If you leave, I will keep asking her.  She may change her mind.  She may not.  You may know her better than I."

Horatio looks at you expectantly.

1) Leave without the capsa.
2) Leave with the capsa, and leave Ash behind.
3) Leave with the capsa, and take Ash with you.
4) Let Horatio read the scroll of taclor.

>1
[Leave without the capsa.]

"I can't do it," you say.  "I can't condemn Ash for the sake of my people.  I can't condemn anyone for the sake of a fairy-tale promise."  You stroke Ash's head one more time.  "I love you, kid," you tell them.  "Say hi to your mom for me."

You place the capsa of taclor back on the desk, step onto the window ledge, and launch yourself into the mist.

    *** You have learned much. ***

Would you like to RESTART, RESTORE a saved game, QUIT, or UNDO the last command?

>undo
Nursery
[Previous turn undone.]

>4
[Let Horatio read the scroll of taclor.]

"I can't do it," you say.  "There's no good solution here.  Even the scroll itself only halts the disease; it doesn't cure it.  Nobody wins."

You turn to Horatio.  "And maybe nobody I care about wins if you read this, but lots of people I don't know win.  And maybe we win anyway.  Or maybe you're just crazy.  It's a risk.  Life is risk.  In the balance, maybe that's enough."

You take a deep breath, and hand him the scroll.  "Read it," you tell him.

Horatio nods, pulls out a small key, inserts it into the side of the capsa, and begins to slowly turn it, exposing the rest of the writing as the scroll is rolled from one rod to the next.  He reads.

Or, rather, he sings.  You've never heard a buzzard sing like this before, but then again, you've never heard anyone sing like this before.  It's a deep, primal song of awakening; of understanding; of comfort.  Ash's beak drops open in amazement and wonder.

Then Aubrey, your friend, your love, your queen, your enemy, bursts through the door.  "Ash!" she cries, then, seeing them safe, turns to Horatio.  "No!" she gasps, and launches herself at him.

1) Get between Aubrey and Horatio.
2) "Aubrey, no!"

>1
[Get between Aubrey and Horatio.]

You fling yourself across the room to stop her, but before she even reaches you, her head jerks back, she stops, then falls twitching to the floor.

Horatio continues to sing.  Ash's face is a mixture of horror and delight.

1) Rush to her side.
2) Shield Ash from the sight.
3) Tell Horatio to stop.

>1
[Rush to her side.]

You rush to the side of your love, cradling her head with your wing.  "Aubrey, darling, be all right.  Listen to me.  Be all right.  I need you.  I need the true you."

The song reaches a crescendo.  The Aerie itself threatens to shake apart.

1) Hold Aubrey tight.

>1
[Hold Aubrey tight.]

You close your eyes and wrap Aubrey with both wings, not to shield her from the song, which is everywhere, even your bones, but just to let her know she's not alone.  She can't be alone when she dies.

You didn't expect the apocalypse to be this pretty.

The song is everywhere.  The song is everything.  It is morningsong.  It is evensong.  It is the tide, and the moons, and the stars.

And threading it together, it is life.  Health.  The roost.  The nest.  A bubble of comfort pushing back against the dark.

And then it's done.  The writing fades from the scroll, and Horatio gently rewinds it back to the title.  "TACHLOR".

Aubrey relaxes, wakes.  Looks into your eyes.  "I'm so sorry," she whispers.  She glances at her child.  "Ash..." she explains.

"I'm sorry, too," you answer.  "My mother," you explain.  You both look at the other with glistening eyes.

Then Aubrey gets a strange expression on her face.  "I... I remember," she says.  "The... Ash.  Come here."

Obediently, Ash comes and perches by her side.

Aubrey begins to sing.  It's not The Song.  Nothing will ever be The Song.  But it's an echo.

As she sings, Ash's pallor fades, and their feathers straighten.  A hunch you didn't realize they had straightens out.  "Oh!" they exclaim.  "OH!"  Their eyes shine.

You help Aubrey to her feet.  She looks around at the four of you, and rises to her full height, full of queenly majesty.  "Come," she says.  "We have work to do."

    *** You have changed the world. ***

Would you like to RESTART, RESTORE a saved game, QUIT, or UNDO the last command?

* * *

>close black
(the black capsa)
You close the black capsa.

The hunting cloaks appear again.

>showme cloak
(the purple hunting cloak)
purple hunting cloak - thing
location: on the two cloak posts in Lower Great Hall
unlit, inedible, portable, wearable; singular-named, improper-named; purple
description: "A plaque by the cloaks claims that in prehistoric times, people made these cloaks out of hippotomai skins to mask their scent.  The dark purple variegation also helped with camoflage.  You couldn't fly with them on, but some prey had gotten extremely adept and spotting flying enemies, so hunters took to sneaking up on foot."
initial appearance: none
printed name: "purple hunting cloak"
printed plural name: none
indefinite article: none
list grouping key: none

>open black
(the black capsa)
You open the black capsa, revealing a scroll of igram.

For a moment, the purple capsa seems to flicker.  But you look again, and nothing seems to have changed.
The hunting cloaks disappear again.

>showme cloak
(the invisible hunting cloak)
invisible hunting cloak - thing
location: on the two cloak posts in Lower Great Hall
unlit, inedible, portable, wearable; singular-named, improper-named; invisible
description: "The cloak posts appear to be empty."
initial appearance: none
printed name: "invisible hunting cloak"
printed plural name: none
indefinite article: none
list grouping key: none

* * *

>x post
Two posts for displaying cloaks.

>x posts
Two posts for displaying cloaks.

>get cloak
(the hunting cloak)
You reach for the post, and feel the cloak you saw.  With a sense of wonderment, you pick it up.  Next to you, Horatio picks up the other, equally-invisible cloak.

Your wound aches.  You look down at it, and it's still open and a fast small trickle of blood drips down your side.

>close purple
Which do you mean, the hunting cloak or the purple capsa of opening?

>open purple
Which do you mean, the hunting cloak or the purple capsa of opening?

>get cloak
(the hunting cloak)
You reach for the post, and feel the cloak you saw.  With a sense of wonderment, you pick it up.  Next to you, Horatio picks up the other, equally-invisible cloak.

>touch posts
You feel nothing unexpected.

>showme posts
two cloak posts - supporter
    hunting cloak
location: in Lower Great Hall
unlit, inedible, fixed in place; transparent; singular-named, improper-named
description: none
initial appearance: none
carrying capacity: 100
printed name: "two cloak posts"
printed plural name: "supporters"
indefinite article: none
list grouping key: none

>showme hunting
(the hunting cloak)
hunting cloak - thing
location: on the two cloak posts in Lower Great Hall
unlit, inedible, portable, wearable; singular-named, improper-named; invisible
description: "You can feel the supple folds of the cloak, but cannot see it at all."
initial appearance: none
printed name: "hunting cloak"
printed plural name: none
indefinite article: none
list grouping key: none

>showme hunting cloak
(the hunting cloak)
hunting cloak - thing
location: on the two cloak posts in Lower Great Hall
unlit, inedible, portable, wearable; singular-named, improper-named; invisible
description: "You can feel the supple folds of the cloak, but cannot see it at all."
initial appearance: none
printed name: "hunting cloak"
printed plural name: none
indefinite article: none
list grouping key: none

>showme purple cloak
hunting cloak - thing
location: on the two cloak posts in Lower Great Hall
unlit, inedible, portable, wearable; singular-named, improper-named; invisible
description: "You can feel the supple folds of the cloak, but cannot see it at all."
initial appearance: none
printed name: "hunting cloak"
printed plural name: none
indefinite article: none
list grouping key: none

>x cloak
(the hunting cloak)
You can feel the supple folds of the cloak, but cannot see it at all.

>get it
You reach for the post, and feel the cloak you saw.  With a sense of wonderment, you pick it up.  Next to you, Horatio picks up the other, equally-invisible cloak.

>touch posts
You feel nothing unexpected.

* * *

>w
Great Hall Landing Cradle
The Landing Cradle of the Great Hall spreads out over nearly a quarter of the vast building.  During your time here, you learned this was so that when a number of important guests and their retinues arrive at the same time, they can land simultaneously, instead of one after the other, which some would invariably take as meaning "in order of importance".  The huge double doors of the Great Hall are on the west side of the landing cradle, and unguarded.

To the north is the Royal Quarters and Gardens, the Librum to the east, and as always, you can return to the skies or descend to the forest.

The momentum you had from your dive wears off.  Fun while it lasted!

>in
Upper Great Hall
There is a small platform just inside the huge double doors of the Great Hall, and that's it.  The platform is lined with a single elegant grown-mahogany branch that wraps around the whole platform.  It varies in size and thickness, so that all types of feet fit somewhere along it, so people can comfortably launch themselves into the air to glide down to the floor level, or grab it for stability as they return.

>d
You step on to your favorite spot on the mahogany branch, and launch yourself downward in a graceful glide.

Lower Great Hall
When not prepared for a particular occasion, like now, the floor of the Great Hall is cleared of everything extraneous.  The exposed floor is absolutely exquisite, with swooping lines interspersed with starbursts, all in multicolored woods of all hues.  What doesn't change about the Great Hall floor is the display nooks along the sides: at least twenty nooks containing all manner of artifacts from around the world.

>x nooks
Old things, new things, distant things, close things.

Your wound continues to lightly bleed.

>close purple
You close the purple capsa of opening.

You feel your skin prickle where you were wounded, and look down.  To your amazement, your wound has closed and the bleeding stopped.  As you watch, even the line from the cut disappears, and the feathers around it fluff out again.

It's the scroll of Health.  It has to be.  It's actually here!  And active.  Hmm.

From everywhere in the Aerie, you hear the woodpeckers drumming in the Pounding dialect: "Reset Locks!  Repeat!  Reset Locks!

>open purple
You open the purple capsa of opening, revealing a scroll of rezrov.

As you open the purple capsa, an almost-palpable wave of force emanates from it, as the power of the revealed scroll of rezrov is released.

The magic of the gold capsa of down prevents it from being opened.
The magic of the red capsa of hasten prevents it from being opened.
The magic of the blue capsa of mist prevents it from being opened.

>l
Lower Great Hall
When not prepared for a particular occasion, like now, the floor of the Great Hall is cleared of everything extraneous.  The exposed floor is absolutely exquisite, with swooping lines interspersed with starbursts, all in multicolored woods of all hues.  What doesn't change about the Great Hall floor is the display nooks along the sides: at least twenty nooks containing all manner of artifacts from around the world.

>z
Time passes.

>x display
You can't see any such thing.

>x cloak
You can't see any such thing.

>u
Upper Great Hall
There is a small platform just inside the huge double doors of the Great Hall, and that's it.  The platform is lined with a single elegant grown-mahogany branch that wraps around the whole platform.  It varies in size and thickness, so that all types of feet fit somewhere along it, so people can comfortably launch themselves into the air to glide down to the floor level, or grab it for stability as they return.

>u
You can't go that way.

>out
Great Hall Landing Cradle
The Landing Cradle of the Great Hall spreads out over nearly a quarter of the vast building.  During your time here, you learned this was so that when a number of important guests and their retinues arrive at the same time, they can land simultaneously, instead of one after the other, which some would invariably take as meaning "in order of importance".  The huge double doors of the Great Hall are on the west side of the landing cradle, and unguarded.

To the north is the Royal Quarters and Gardens, the Librum to the east, and as always, you can return to the skies or descend to the forest.

* * *

>test scenery
(Testing.)

>[1] x aerie
As you recall, the Royal Aerie was grown and shaped by generations of Throckrites, and now towers over the surrounding forest canopy.  Lush shades of browns and reds, often woven together in intricate patterns or pictures, cover every landing cradle and wall.

>[2] x royal quarters
As you recall, the Royal Quarters is where the Queen and her family, servants, and certain privileged royalty live.  Every huge common room; every small or large individual apartment is awash in greenery that looks incredibly inviting and imperially homey, and is in reality subtly precisely hostile to the uninvited.  Every roof pitch is too steep; no branch nor ridge is graspable by talons of any size.  The single landing cradle in the middle of the gardens is surrounded by stern and beautiful tree crowns, beset with nooks and crevices for unseen guards and archers: attempting to land there would mean instant death for any but those who belong.

>[3] x librum
As you recall, the Librum was your target the last time out, and where you obtained the capsas you brought back with you. Its landing cradle is simply decorated, grown with interlocking redwood and pine in a way that suggests shelves of books.  The reading nooks grown into the sides of the main building proved a reasonable entrance for a creative supplicant; no doubt that method will have been shut down by now.

>[4] x great hall
As you recall, the Great Hall is by far the largest building in the Aerie complex, and indeed the largest building you've ever seen in your life.  If the stories are true, its planning took three years, and its growth was overseen by three generations of Throckrites.  Every Royal Throckrite since has sought to put their own personal stamp on the Great Hall, leaving it more than a little haphazardly grown by now, but its current form is still impressive, even as it grows less coherent with every new modification.