Your mother needs you.  The whole village needs you.  You can do this.  You must do this.

The mantra repeats in your head, pushing you on as you wheel in circles over the forest canopy, riding thermals to heights where none but other Falcon Clan members could see you.  And there's no more Falcon Clan in the Royal Aerie--you and the rest of your clan were all banished years ago.  Three days ago, approaching from underneath worked, as none were expecting it.  But while technically successful, you failed to snatch your intended quarry: the Scroll of Health.  The sages had been unable to tell you what color capsa would hold it: you now know that it's not purple, gold, nor red.

By tonight, you will know.  You're not leaving without it.

course correction
An Interactive High Heist by Lucian Smith
Release 0 / Serial number 260223 / Inform 7 v10.1.2 / D

High Above the Royal Aerie
You drift in lazy circles well above the Royal Aerie below, safely above your quarry.  Your acute eyesight lets you see the entire layout, and how it relates to today's air currents, winds, and thermals.  Royal quarters to the north, well defended by circling Raven clan guards.  The librum to the east.  {LS DEBUG: a few other rooms.  Presumably.  Kitchen, Barracks, Chapel(?), }  In the center of the Aerie (and directly below you) is the Great Hall.

>d
If you get any closer to the aerie without summoning mist first, the guards would surely see you.  It's why, as a Bostrat, you were originally chosen to go on this mission.

* * *

>summon mist
Calling on your heritage as a Bostrat, you summon moisture from the air, and it slowly coalesces into a creeping grey mist, obscuring you from sight.  In gentler times, you would be doing this to ensure the growth of the fields and forests; now you must use it to hide from prying eyes that would keep you from your quarry.

You stop at the natural inflection point for clouds given today's weather.  You could make it thicker still, but it would then start to dissapate.

>summon mist
You draw even more moisture into the air, and feed it into the mist.  It thickensIt's still just as obscuring as before, but you feel safer, as you always do in the midst of clouds.

woo PEMDAS.

>summon mist
You draw even more moisture into the air, and feed it into the mist.  It thickensIt's still just as obscuring as before, but you feel safer, as you always do in the midst of clouds.

woo PEMDAS.

>summon mist
You draw even more moisture into the air, and feed it into the mist.  It thickensIt's still just as obscuring as before, but you feel safer, as you always do in the midst of clouds.

>summon mist
You draw even more moisture into the air, and feed it into the mist.  It thickensIt's still just as obscuring as before, but you feel safer, as you always do in the midst of clouds.

>z
Time passes.

>scenes
Scene 'Entire Game' playing (for 11 mins now)
Scene 'Mist depletion' playing (for 9 mins now)
Scene 'Starting off' playing (for 11 mins now)
(Scene monitoring now switched on. Type "scenes off" to switch it off again.)

* * *

>d
If you get any closer to the aerie without summoning mist first, the guards would surely see you.  It's why, as a Bostrat, you were originally chosen to go on this mission.

>u
You're already high enough to avoid being seen from below; there's no need to go higher.

>dive
You'll need to SUMMON MIST first, to cloak your descent.

>summon mist
Calling on your heritage as a Bostrat, you summon moisture from the air, and it slowly coalesces into a creeping grey mist, obscuring you from sight.  In gentler times, you would be doing this to ensure the growth of the fields and forests; now you must use it to hide from prying eyes that would keep you from your quarry.

You stop at the natural inflection point for clouds given today's weather.  You could make it thicker still, but it would then start to dissapate.

>dive
You descend in wide circles, pulling mist down with you in what you hope is a sufficiently unsuspicious manner, trusting your memorization of the air currents to tell you where you're going...

Great Hall Landing Cradle
The Landing Cradle of the Great Hall spreads out over nearly a quarter of the vast building.  During your time here, you learned this was so that when a number of important guests and their retinues arrive at the same time, they can land simultaneously, instead of one after the other, which some would invariably take as meaning "in order of importance".

To the north is the Royal Quarters, the Librum to the east, {other places LS DEBUG}, and as always, you can return to the skies or descend to the forest.

You can see an important door here.

>u
High Above the Royal Aerie
Your summoned mist both obscures you and blocks you from seeing the Royal Aerie.  But you've already memorized its layout, and how it relates to today's air currents, winds, and thermals.  Royal quarters to the north, well defended by circling Raven clan guards.  The librum to the east.  {LS DEBUG: a few other rooms.  Presumably.  Kitchen, Barracks, Chapel(?), }  In the center of the Aerie (and directly below you) is the Great Hall.

>dive
You tuck in your wings and dive down towards the Aerie, thrilling to the misty wind streaming through your feathers.

Great Hall Landing Cradle
The Landing Cradle of the Great Hall spreads out over nearly a quarter of the vast building.  During your time here, you learned this was so that when a number of important guests and their retinues arrive at the same time, they can land simultaneously, instead of one after the other, which some would invariably take as meaning "in order of importance".

To the north is the Royal Quarters, the Librum to the east, {other places LS DEBUG}, and as always, you can return to the skies or descend to the forest.

You can see an important door here.

>dive
You tuck in your wings and dive down into the forest below the Aerie, dodging tightly-spaced trees with acrobatic precision.

In the Forest
The trees below the Royal Aerie grow more closely together than in the rest of the forest, and include a wider variety, so that differently-colored woods could be incorporated into the buildings above.  This makes it harder to navigate down here--or it would if you weren't so amazing at navigation.

Even through the mist, your sharp eyes spot a fine net, stretched between the trees.  It seems to be set to prevent anyone from coming up from the forest below.

>z
Time passes.

>z
Time passes.

The momentum you had from your dive wears off.  Fun while it lasted!

>u
Great Hall Landing Cradle
The Landing Cradle of the Great Hall spreads out over nearly a quarter of the vast building.  During your time here, you learned this was so that when a number of important guests and their retinues arrive at the same time, they can land simultaneously, instead of one after the other, which some would invariably take as meaning "in order of importance".

To the north is the Royal Quarters, the Librum to the east, {other places LS DEBUG}, and as always, you can return to the skies or descend to the forest.

You can see an important door here.

>u
High Above the Royal Aerie
Your summoned mist both obscures you and blocks you from seeing the Royal Aerie.  But you've already memorized its layout, and how it relates to today's air currents, winds, and thermals.  Royal quarters to the north, well defended by circling Raven clan guards.  The librum to the east.  {LS DEBUG: a few other rooms.  Presumably.  Kitchen, Barracks, Chapel(?), }  In the center of the Aerie (and directly below you) is the Great Hall.

>d
You tuck in your wings and dive down towards the Aerie, thrilling to the misty wind streaming through your feathers.

Great Hall Landing Cradle
The Landing Cradle of the Great Hall spreads out over nearly a quarter of the vast building.  During your time here, you learned this was so that when a number of important guests and their retinues arrive at the same time, they can land simultaneously, instead of one after the other, which some would invariably take as meaning "in order of importance".

To the north is the Royal Quarters, the Librum to the east, {other places LS DEBUG}, and as always, you can return to the skies or descend to the forest.

You can see an important door here.

>z
Time passes.

The momentum you had from your dive wears off.  Fun while it lasted!

* * *

>showme being chased
There seems to be no such object anywhere in the model world.

>scenes
Scene 'Entire Game' playing (for 0 mins now)
Scene 'Starting Off' playing (for 0 mins now)
(Scene monitoring now switched on. Type "scenes off" to switch it off again.)

>showme the closeness of being chased
There seems to be no such object anywhere in the model world.

>open purple
You open the purple capsa of opening, revealing a scroll of rezrov.

[Scene 'Everything Is Open' begins]
As you open the purple capsa, an almost-palpable wave of force emanates from it, as the power of the revealed scroll of rezrov is released.
The magic of the gold capsa of FOO prevents it from being opened.
The magic of the red capsa of BAR prevents it from being opened.
The straps and buckles on your rucksack fly open and it falls!

The leather rucksack twists away as it falls below you, towards the Great Hall.

[Scene 'Being Chased' begins]
From... well, from everywhere in the Aerie, it seems, Woodpeckers start drumming out messages in their Pounding Dialect:  "Intruder! Estimated direction is..." and then each one individually seems to be telegraphing the direction from them to you.  You can't discern any one drummer from any other drummer, but you can at least tell that each seems to be drumming on sheets of metal that differ from each other, as the frequencies are all different from each other.  That makes the information somewhat useless to you, because you've not been trained to distinguish Pounding at different frequencies.  And because you already know where you are.  Sadly, the Raven Guards are indeed trained to distinguish Pounding frequencies, and they don't know where you are.  Or they didn't, at least.

closeness: 1.

>z
Time passes.

closeness: 2.
Raven guards appear!

* * *

>summon mist
Calling on your heritage as a Bostrat, you summon moisture from the air, and it slowly coalesces into a creeping grey mist, obscuring you from sight.  In gentler times, you would be doing this to ensure the growth of the fields and forests; now you must use it to hide from prying eyes that would keep you from your quarry.

You stop at the natural inflection point for clouds given today's weather.  You could make it thicker still, but it would then start to dissapate.

>d
You descend in wide circles, pulling mist down with you in what you hope is a sufficiently unsuspicious manner, trusting your memorization of the air currents to tell you where you're going...

Great Hall Landing Cradle
The Landing Cradle of the Great Hall spreads out over nearly a quarter of the vast building.  During your time here, you learned this was so that when a number of important guests and their retinues arrive at the same time, they can land simultaneously, instead of one after the other, which some would invariably take as meaning "in order of importance".

To the north is the Royal Quarters, the Librum to the east, {other places LS DEBUG}, and as always, you can return to the skies or descend to the forest.

You can see an important door here.

>u
High Above the Royal Aerie
Your summoned mist both obscures you and blocks you from seeing the Royal Aerie.  But you've already memorized its layout, and how it relates to today's air currents, winds, and thermals.  Royal quarters to the north, well defended by circling Raven clan guards.  The librum to the east.  {LS DEBUG: a few other rooms.  Presumably.  Kitchen, Barracks, Chapel(?), }  In the center of the Aerie (and directly below you) is the Great Hall.

>d
You tuck in your wings and dive down towards the Aerie, thrilling to the misty wind streaming through your feathers.

Great Hall Landing Cradle
The Landing Cradle of the Great Hall spreads out over nearly a quarter of the vast building.  During your time here, you learned this was so that when a number of important guests and their retinues arrive at the same time, they can land simultaneously, instead of one after the other, which some would invariably take as meaning "in order of importance".

To the north is the Royal Quarters, the Librum to the east, {other places LS DEBUG}, and as always, you can return to the skies or descend to the forest.

You can see an important door here.

The momentum you had from your dive wears off.  Fun while it lasted!

>d
You tuck in your wings and dive down into the forest below the Aerie, dodging tightly-spaced trees with acrobatic precision.

In the Forest
The trees below the Royal Aerie grow more closely together than in the rest of the forest, and include a wider variety, so that differently-colored woods could be incorporated into the buildings above.  This makes it harder to navigate down here--or it would if you weren't so amazing at navigation.

Even through the mist, your sharp eyes spot a fine net, stretched between the trees.  It seems to be set to prevent anyone from coming up from the forest below.

The momentum you had from your dive wears off.  Fun while it lasted!

* * *

>summon mist
Calling on your heritage as a Bostrat, you summon moisture from the air, and it slowly coalesces into a creeping grey mist, obscuring you from sight.  In gentler times, you would be doing this to ensure the growth of the fields and forests; now you must use it to hide from prying eyes that would keep you from your quarry.

You stop at the natural inflection point for clouds given today's weather.  You could make it thicker still, but it would then start to dissapate.

>open purple
You open the purple capsa of opening, revealing a scroll of rezrov.

As you open the purple capsa, an almost-palpable wave of force emanates from it, as the power of the revealed scroll of rezrov is released.
The magic of the gold capsa of FOO prevents it from being opened.
The magic of the red capsa of BAR prevents it from being opened.
The straps and buckles on your rucksack fly open and it falls!

The leather rucksack twists away as it falls below you, towards the Great Hall.

From... well, from everywhere in the Aerie, it seems, Woodpeckers start drumming out messages in their Pounding dialect:  "Intruder! Estimated direction is..." and then each one individually seems to be telegraphing the direction from them to you.  You can't discern any one drummer from any other drummer, but you can at least tell that each seems to be drumming on sheets of metal that differ from each other, as the frequencies are all different from each other.  That makes the information somewhat useless to you, because you've not been trained to distinguish Pounding at different frequencies.  And because you already know where you are.  Sadly, the Raven Guards are indeed trained to distinguish Pounding frequencies, and they don't know where you are.

Or they didn't, at least.

>d
You descend in wide circles, pulling mist down with you in what you hope is a sufficiently unsuspicious manner, trusting your memorization of the air currents to tell you where you're going...

Great Hall Landing Cradle
The Landing Cradle of the Great Hall spreads out over nearly a quarter of the vast building.  During your time here, you learned this was so that when a number of important guests and their retinues arrive at the same time, they can land simultaneously, instead of one after the other, which some would invariably take as meaning "in order of importance".

To the north is the Royal Quarters, the Librum to the east, {other places LS DEBUG}, and as always, you can return to the skies or descend to the forest.

You can see a leather rucksack (in which are a purple capsa of opening (in which is a scroll of rezrov), a gold capsa of FOO (closed), and a red capsa of BAR (closed)) and an important door here.

You've dived straight into a squad of Raven Guards, on their way up to accost you.  Fortunately, your speed helped you avoid most of them, but one guard's talon catches you on your side as you twist by them.

>e
Librum Landing Cradle
The Landing Cradle of the Librum is beautifully set with interlocking redwood and pine, suggesting shelves of books.  {Probably be more descriptive here LS DEBUG}.

To the west is the Great Hall, and to the northwest is the Royal Quarters.  {also up/down}

You can see Another Important Door here.

closeness: 3.
The Raven Squad pursues you determinedly through the thin mist.

>n
You can't go that way.

closeness: 3.
The guards charge, but you manage to evade their uncoordinated attack.

Your wound continues to lightly bleed.

>summon mist
You draw even more moisture into the air, and feed it into the mist.  As it thickens, you feel safer, as you always do in the midst of clouds.

closeness: 4.
Two guards snap at you, and while both touch nothing but feathers, a third slashes you with his silvered talons.  They're about to overwhelm you.

Your wound aches.  You look down at it, and it's still open and bleeding.
.

>undo
Librum Landing Cradle
[Previous turn undone.]

I beg your pardon?

* * *

>e
Librum Landing Cradle
The Landing Cradle of the Librum is beautifully set with interlocking redwood and pine, suggesting shelves of books.  {Probably be more descriptive here LS DEBUG}.

To the west is the Great Hall, and to the northwest is the Royal Quarters.  {also up/down}

You can see Another Important Door here.

closeness: 3.
The Raven Squad pursues you determinedly through the thin mist.

>nw
Royal Landing Cradle
It's dangerous; you can't do anything here yet. LS DEBUG.  (you can go south, southeast, up, down)

closeness: 3.
The Raven Squad pursues you determinedly through the thin mist.

>s
Great Hall Landing Cradle
The Landing Cradle of the Great Hall spreads out over nearly a quarter of the vast building.  During your time here, you learned this was so that when a number of important guests and their retinues arrive at the same time, they can land simultaneously, instead of one after the other, which some would invariably take as meaning "in order of importance".

To the north is the Royal Quarters, the Librum to the east, {other places LS DEBUG}, and as always, you can return to the skies or descend to the forest.

You can see a leather rucksack (in which are a purple capsa of opening (in which is a scroll of rezrov), a gold capsa of FOO (closed), and a red capsa of BAR (closed)) and an important door here.

closeness: 3.
The Raven Squad pursues you determinedly through the thin mist.

>d
You tuck in your wings and dive down into the forest below the Aerie, dodging tightly-spaced trees with acrobatic precision.

In the Forest
The trees below the Royal Aerie grow more closely together than in the rest of the forest, and include a wider variety, so that differently-colored woods could be incorporated into the buildings above.  This makes it harder to navigate down here--or it would if you weren't so amazing at navigation.

Even through the mist, your sharp eyes spot a fine net, stretched between the trees.  It seems to be set to prevent anyone from coming up from the forest below.

closeness: 3.
Your speed puts more distance between you and your pursuers, but it's not quite fast enough, or the mist isn't thick enough, or both, and your pursuers manage to keep you in sight.

>summon mist
You draw even more moisture into the air, and feed it into the mist.  As it thickens, you feel safer, as you always do in the midst of clouds.

closeness: 3.
The guards charge, but you manage to evade their uncoordinated attack.

The momentum you had from your dive wears off.

>summon mist
You draw even more moisture into the air, and feed it into the mist.  As it thickens, you feel safer, as you always do in the midst of clouds.

closeness: 4.
Two guards snap at you, and while both touch nothing but feathers, a third slashes you with his silvered talons.  They're about to overwhelm you.

>z
Time passes.

closeness: 5.
You're faster and more maneuverable than they are, but there are more of them.  One charges you directly, and when you veer off to avoid her, another crashes into you.  The rest swarm you instantly.

    *** Your luck has run out. ***

Would you like to RESTART, RESTORE a saved game, QUIT, or UNDO the last command?

>undo
In the Forest
[Previous turn undone.]

>u
Great Hall Landing Cradle
The Landing Cradle of the Great Hall spreads out over nearly a quarter of the vast building.  During your time here, you learned this was so that when a number of important guests and their retinues arrive at the same time, they can land simultaneously, instead of one after the other, which some would invariably take as meaning "in order of importance".

To the north is the Royal Quarters, the Librum to the east, {other places LS DEBUG}, and as always, you can return to the skies or descend to the forest.

You can see a leather rucksack (in which are a purple capsa of opening (in which is a scroll of rezrov), a gold capsa of FOO (closed), and a red capsa of BAR (closed)) and an important door here.

closeness: 5.
The Raven Squad pursues you determinedly through the mist.

>d
You tuck in your wings and dive down into the forest below the Aerie, dodging tightly-spaced trees with acrobatic precision.

In the Forest
The trees below the Royal Aerie grow more closely together than in the rest of the forest, and include a wider variety, so that differently-colored woods could be incorporated into the buildings above.  This makes it harder to navigate down here--or it would if you weren't so amazing at navigation.

Even through the mist, your sharp eyes spot a fine net, stretched between the trees.  It seems to be set to prevent anyone from coming up from the forest below.

Your summoned mist thins slightly, on its way back to equilibrium.

closeness: 3.
Your speed puts more distance between you and your pursuers, but it's not quite fast enough, or the mist isn't thick enough, or both, and your pursuers manage to keep you in sight.

>d
You can't go that way.

closeness: 3.
The guards charge, but you manage to evade their uncoordinated attack.

The momentum you had from your dive wears off.

>u
Great Hall Landing Cradle
The Landing Cradle of the Great Hall spreads out over nearly a quarter of the vast building.  During your time here, you learned this was so that when a number of important guests and their retinues arrive at the same time, they can land simultaneously, instead of one after the other, which some would invariably take as meaning "in order of importance".

To the north is the Royal Quarters, the Librum to the east, {other places LS DEBUG}, and as always, you can return to the skies or descend to the forest.

You can see a leather rucksack (in which are a purple capsa of opening (in which is a scroll of rezrov), a gold capsa of FOO (closed), and a red capsa of BAR (closed)) and an important door here.

closeness: 4.
The Raven Squad pursues you determinedly through the mist.

>u
High Above the Royal Aerie
Your summoned mist both obscures you and blocks you from seeing the Royal Aerie.  But you've already memorized its layout, and how it relates to today's air currents, winds, and thermals.  Royal quarters to the north, well defended by circling Raven clan guards.  The librum to the east.  {LS DEBUG: a few other rooms.  Presumably.  Kitchen, Barracks, Chapel(?), }  In the center of the Aerie (and directly below you) is the Great Hall.

Your summoned mist thins slightly, on its way back to equilibrium.

closeness: 3.
The Raven Squad pursues you determinedly through the thin mist.

>d
You tuck in your wings and dive down towards the Aerie, thrilling to the misty wind streaming through your feathers.

Great Hall Landing Cradle
The Landing Cradle of the Great Hall spreads out over nearly a quarter of the vast building.  During your time here, you learned this was so that when a number of important guests and their retinues arrive at the same time, they can land simultaneously, instead of one after the other, which some would invariably take as meaning "in order of importance".

To the north is the Royal Quarters, the Librum to the east, {other places LS DEBUG}, and as always, you can return to the skies or descend to the forest.

You can see a leather rucksack (in which are a purple capsa of opening (in which is a scroll of rezrov), a gold capsa of FOO (closed), and a red capsa of BAR (closed)) and an important door here.

closeness: 3.
Your speed puts more distance between you and your pursuers, but it's not quite fast enough, or the mist isn't thick enough, or both, and your pursuers manage to keep you in sight.

>d
You tuck in your wings and dive down into the forest below the Aerie, dodging tightly-spaced trees with acrobatic precision.

In the Forest
The trees below the Royal Aerie grow more closely together than in the rest of the forest, and include a wider variety, so that differently-colored woods could be incorporated into the buildings above.  This makes it harder to navigate down here--or it would if you weren't so amazing at navigation.

Even through the mist, your sharp eyes spot a fine net, stretched between the trees.  It seems to be set to prevent anyone from coming up from the forest below.

Your summoned mist thins back to equilibrium.  Still thick enough to mostly obscure you, but you'll have to be careful.

closeness: 3.
You expertly twist at breakneck speeds, weaving through three Ash trunks, over a branch, and around and behind a Redwood, where you halt, twist, and dive straight down the trunk, out of view of any stray Raven.

High Above the Royal Aerie
Your summoned mist both obscures you and blocks you from seeing the Royal Aerie.  But you've already memorized its layout, and how it relates to today's air currents, winds, and thermals.  Royal quarters to the north, well defended by circling Raven clan guards.  The librum to the east.  {LS DEBUG: a few other rooms.  Presumably.  Kitchen, Barracks, Chapel(?), }  In the center of the Aerie (and directly below you) is the Great Hall.

The Raven's frustrated caws echo in the mist, and you plot a now-unseen course returning to the familiar currents above the Aerie.  In time, the woodpeckers cease their drumming, and the cawing fades as well.  Protocol would dictate that they return to guarding priority items, but increase patrols.

>scenes
Scene 'Entire Game' playing (for 16 mins now)
Scene 'Mist depletion' ended
Scene 'Starting Off' ended
Scene 'Everything Is Open' playing (for 15 mins now)
Scene 'Momentum' ended
Scene 'Super-momentum' playing (for 1 mins now)
Scene 'Being Chased' ended
Scene 'Not Recovering' playing (for 13 mins now)
(Scene monitoring now switched on. Type "scenes off" to switch it off again.)

>u
You're already high enough to avoid being seen from below; there's no need to go higher.

[Scene 'Super-momentum' ends]
[Scene 'Momentum' begins]

>u
You're already high enough to avoid being seen from below; there's no need to go higher.

>summon mist
You draw even more moisture into the air, and feed it into the mist.  As it thickens, you feel safer, as you always do in the midst of clouds.

[Scene 'Mist depletion' begins]
[Scene 'Momentum' ends]
The momentum you had from your dive wears off.
  Fun while it lasted!

>summon mist
You draw even more moisture into the air, and feed it into the mist.  As it thickens, you feel safer, as you always do in the midst of clouds.

>d
You tuck in your wings and dive down towards the Aerie, thrilling to the misty wind streaming through your feathers.

Great Hall Landing Cradle
The Landing Cradle of the Great Hall spreads out over nearly a quarter of the vast building.  During your time here, you learned this was so that when a number of important guests and their retinues arrive at the same time, they can land simultaneously, instead of one after the other, which some would invariably take as meaning "in order of importance".

To the north is the Royal Quarters, the Librum to the east, {other places LS DEBUG}, and as always, you can return to the skies or descend to the forest.

You can see a leather rucksack (in which are a purple capsa of opening (in which is a scroll of rezrov), a gold capsa of FOO (closed), and a red capsa of BAR (closed)) and an important door here.

[Scene 'Momentum' begins]

>summon mist
You draw even more moisture into the air, and feed it into the mist.  As it thickens, you feel safer, as you always do in the midst of clouds.

[Scene 'Momentum' ends]
The momentum you had from your dive wears off.
  Fun while it lasted!

>u
High Above the Royal Aerie
Your summoned mist both obscures you and blocks you from seeing the Royal Aerie.  But you've already memorized its layout, and how it relates to today's air currents, winds, and thermals.  Royal quarters to the north, well defended by circling Raven clan guards.  The librum to the east.  {LS DEBUG: a few other rooms.  Presumably.  Kitchen, Barracks, Chapel(?), }  In the center of the Aerie (and directly below you) is the Great Hall.

>summon mist
You draw even more moisture into the air, and feed it into the mist.  As it thickens, you feel safer, as you always do in the midst of clouds.

* * *

>summon mist
You draw even more moisture into the air, and feed it into the mist.  As it thickens, you feel safer, as you always do in the midst of clouds.

The guards charge, but you manage to evade their uncoordinated attack.

>u
High Above the Royal Aerie
Your summoned mist both obscures you and blocks you from seeing the Royal Aerie.  But you've already memorized its layout, and how it relates to today's air currents, winds, and thermals.  Royal quarters to the north, well defended by circling Raven clan guards.  The librum to the east.  {LS DEBUG: a few other rooms.  Presumably.  Kitchen, Barracks, Chapel(?), }  In the center of the Aerie (and directly below you) is the Great Hall.

The Raven Squad pursues you determinedly through the mist.

>summon mist
You draw even more moisture into the air, and feed it into the mist.  As it thickens, you feel safer, as you always do in the midst of clouds.

The guards charge, but you manage to evade their uncoordinated attack.

>e
You tuck in your wings and dive down towards the Aerie, thrilling to the misty wind streaming through your feathers.

Librum Landing Cradle
The Landing Cradle of the Librum is beautifully set with interlocking redwood and pine, suggesting shelves of books.  {Probably be more descriptive here LS DEBUG}.

To the west is the Great Hall, and to the northwest is the Royal Quarters.  {also up/down}

You can see Another Important Door here.

Your speed puts more distance between you and your pursuers, but it's not quite fast enough, or the mist isn't thick enough, or both, and your pursuers manage to keep you in sight.

>summon mist
You draw even more moisture into the air, and feed it into the mist.  As it thickens, you feel safer, as you always do in the midst of clouds.

The guards charge, but you manage to evade their uncoordinated attack.

The momentum you had from your dive wears off.

>nw
Royal Landing Cradle
It's dangerous; you can't do anything here yet. LS DEBUG.  (you can go south, southeast, up, down)

The Raven Squad pursues you determinedly through the thickening mist.

>summon mist
You draw even more moisture into the air, and feed it into the mist.  As it thickens, you feel safer, as you always do in the midst of clouds.

The guards charge, but you manage to evade their uncoordinated attack.

>s
Great Hall Landing Cradle
The Landing Cradle of the Great Hall spreads out over nearly a quarter of the vast building.  During your time here, you learned this was so that when a number of important guests and their retinues arrive at the same time, they can land simultaneously, instead of one after the other, which some would invariably take as meaning "in order of importance".

To the north is the Royal Quarters, the Librum to the east, {other places LS DEBUG}, and as always, you can return to the skies or descend to the forest.

You can see a leather rucksack (in which are a purple capsa of opening (in which is a scroll of rezrov), a gold capsa of FOO (closed), and a red capsa of BAR (closed)) and an important door here.

The mist is too thick for the Raven Squad to pursue you far.  You dodge around a tree, and disappear.
The Raven's frustrated caws echo in the mist, and you plot a now-unseen course returning to the familiar currents above the Aerie.  In time, the woodpeckers cease their drumming, and the cawing fades as well.  Protocol would dictate that they return to guarding priority items, but increase patrols.

High Above the Royal Aerie
Your summoned mist both obscures you and blocks you from seeing the Royal Aerie.  But you've already memorized its layout, and how it relates to today's air currents, winds, and thermals.  Royal quarters to the north, well defended by circling Raven clan guards.  The librum to the east.  {LS DEBUG: a few other rooms.  Presumably.  Kitchen, Barracks, Chapel(?), }  In the center of the Aerie (and directly below you) is the Great Hall.

* * *

>e
You descend in wide circles, pulling mist down with you in what you hope is a sufficiently unsuspicious manner, trusting your memorization of the air currents to tell you where you're going...

Librum Landing Cradle
The Landing Cradle of the Librum is beautifully set with interlocking redwood and pine, suggesting shelves of books.  {Probably be more descriptive here LS DEBUG}.

To the west is the Great Hall, and to the northwest is the Royal Quarters.  {also up/down}

You can see Another Important Door here.

closeness: 2.
You've dived straight into a squad of Raven Guards, on their way up to accost you.  Fortunately, your speed helped you avoid most of them, but one guard's talon catches you on your side as you twist by them.

>w
Great Hall Landing Cradle
The Landing Cradle of the Great Hall spreads out over nearly a quarter of the vast building.  During your time here, you learned this was so that when a number of important guests and their retinues arrive at the same time, they can land simultaneously, instead of one after the other, which some would invariably take as meaning "in order of importance".

To the north is the Royal Quarters, the Librum to the east, {other places LS DEBUG}, and as always, you can return to the skies or descend to the forest.

You can see a leather rucksack (in which are a purple capsa of opening (in which is a scroll of rezrov), a gold capsa of FOO (closed), and a red capsa of BAR (closed)) and an important door here.

closeness: 3.
The Raven Squad pursues you determinedly through the thin mist.

>summon mist
You draw even more moisture into the air, and feed it into the mist.  As it thickens, you feel safer, as you always do in the midst of clouds.

closeness: 3.
The guards charge, but you manage to evade their uncoordinated attack.

Your wound continues to lightly bleed.

>n
Royal Landing Cradle
It's dangerous; you can't do anything here yet. LS DEBUG.  (you can go south, southeast, up, down)

closeness: 4.
The Raven Squad pursues you determinedly through the mist.

>summon mist
You draw even more moisture into the air, and feed it into the mist.  As it thickens, you feel safer, as you always do in the midst of clouds.

closeness: 3.
The guards charge, but you manage to evade their uncoordinated attack.

>se
Librum Landing Cradle
The Landing Cradle of the Librum is beautifully set with interlocking redwood and pine, suggesting shelves of books.  {Probably be more descriptive here LS DEBUG}.

To the west is the Great Hall, and to the northwest is the Royal Quarters.  {also up/down}

You can see Another Important Door here.

closeness: 4.
The Raven Squad pursues you determinedly through the mist.

>summon mist
You draw even more moisture into the air, and feed it into the mist.  As it thickens, you feel safer, as you always do in the midst of clouds.

closeness: 3.
The guards charge, but you manage to evade their uncoordinated attack.

>w
Great Hall Landing Cradle
The Landing Cradle of the Great Hall spreads out over nearly a quarter of the vast building.  During your time here, you learned this was so that when a number of important guests and their retinues arrive at the same time, they can land simultaneously, instead of one after the other, which some would invariably take as meaning "in order of importance".

To the north is the Royal Quarters, the Librum to the east, {other places LS DEBUG}, and as always, you can return to the skies or descend to the forest.

You can see a leather rucksack (in which are a purple capsa of opening (in which is a scroll of rezrov), a gold capsa of FOO (closed), and a red capsa of BAR (closed)) and an important door here.

closeness: 4.
The Raven Squad pursues you determinedly through the thickening mist.

>summon mist
You draw even more moisture into the air, and feed it into the mist.  As it thickens, you feel safer, as you always do in the midst of clouds.

closeness: 3.
The guards charge, but you manage to evade their uncoordinated attack.

>u
High Above the Royal Aerie
Your summoned mist both obscures you and blocks you from seeing the Royal Aerie.  But you've already memorized its layout, and how it relates to today's air currents, winds, and thermals.  Royal quarters to the north, well defended by circling Raven clan guards.  The librum to the east.  {LS DEBUG: a few other rooms.  Presumably.  Kitchen, Barracks, Chapel(?), }  In the center of the Aerie (and directly below you) is the Great Hall.

closeness: 4.
The Raven Squad pursues you determinedly through the heavy mist.

>summon mist
That's as thick as you can make the mist--there's simply no more water to pull into the air.

closeness: 3.
The guards charge, but you manage to evade their uncoordinated attack.

>d
You tuck in your wings and dive down towards the Aerie, thrilling to the misty wind streaming through your feathers.

Great Hall Landing Cradle
The Landing Cradle of the Great Hall spreads out over nearly a quarter of the vast building.  During your time here, you learned this was so that when a number of important guests and their retinues arrive at the same time, they can land simultaneously, instead of one after the other, which some would invariably take as meaning "in order of importance".

To the north is the Royal Quarters, the Librum to the east, {other places LS DEBUG}, and as always, you can return to the skies or descend to the forest.

You can see a leather rucksack (in which are a purple capsa of opening (in which is a scroll of rezrov), a gold capsa of FOO (closed), and a red capsa of BAR (closed)) and an important door here.

closeness: 4.
You dive into the thickest spot of mist you can find, and put on a final burst of speed before changing direction and dropping like a stone.  It works:  your pursuers fly blindly into the mist, unable to follow.
The Raven's frustrated caws echo in the mist, and you plot a now-unseen course returning to the familiar currents above the Aerie.  In time, the woodpeckers cease their drumming, and the cawing fades as well.  Protocol would dictate that they return to guarding priority items, but increase patrols.

High Above the Royal Aerie
Your summoned mist both obscures you and blocks you from seeing the Royal Aerie.  But you've already memorized its layout, and how it relates to today's air currents, winds, and thermals.  Royal quarters to the north, well defended by circling Raven clan guards.  The librum to the east.  {LS DEBUG: a few other rooms.  Presumably.  Kitchen, Barracks, Chapel(?), }  In the center of the Aerie (and directly below you) is the Great Hall.

>restart
Are you sure you want to restart?

>y
Your mother needs you.  The whole village needs you.  You can do this.  You must do this.

The mantra repeats in your head, pushing you on as you wheel in circles over the forest canopy, riding thermals to heights where none but other Falcon Clan members could see you.  And there's no more Falcon Clan in the Royal Aerie--you and the rest of your clan were all banished years ago.  Three days ago, approaching from underneath worked, as none were expecting it.  But while technically successful, you failed to snatch your intended quarry: the Scroll of Health.  The sages had been unable to tell you what color capsa would hold it: you now know that it's not purple, gold, nor red.

By tonight, you will know.  You're not leaving without it.

course correction
An Interactive High Heist by Lucian Smith
Release 0 / Serial number 260223 / Inform 7 v10.1.2 / D

High Above the Royal Aerie
You drift in lazy circles well above the Royal Aerie below, safely above your quarry.  Your acute eyesight lets you see the entire layout, and how it relates to today's air currents, winds, and thermals.  Royal quarters to the north, well defended by circling Raven clan guards.  The librum to the east.  {LS DEBUG: a few other rooms.  Presumably.  Kitchen, Barracks, Chapel(?), }  In the center of the Aerie (and directly below you) is the Great Hall.

>summon mist
Calling on your heritage as a Bostrat, you summon moisture from the air, and it slowly coalesces into a creeping grey mist, obscuring you from sight.  In gentler times, you would be doing this to ensure the growth of the fields and forests; now you must use it to hide from prying eyes that would keep you from your quarry.

You stop at the natural inflection point for clouds given today's weather.  You could make it thicker still, but it would then start to dissapate.

>open purple
You open the purple capsa of opening, revealing a scroll of rezrov.

As you open the purple capsa, an almost-palpable wave of force emanates from it, as the power of the revealed scroll of rezrov is released.
The magic of the gold capsa of FOO prevents it from being opened.
The magic of the red capsa of BAR prevents it from being opened.
The straps and buckles on your rucksack fly open and it falls!

The leather rucksack twists away as it falls below you, towards the Great Hall.

From... well, from everywhere in the Aerie, it seems, Woodpeckers start drumming out messages in their Pounding dialect:  "Intruder! Estimated direction is..." and then each one individually seems to be telegraphing the direction from them to you.  You can't discern any one drummer from any other drummer, but you can at least tell that each seems to be drumming on sheets of metal that differ from each other, as the frequencies are all different from each other.  That makes the information somewhat useless to you, because you've not been trained to distinguish Pounding at different frequencies.  And because you already know where you are.  Sadly, the Raven Guards are indeed trained to distinguish Pounding frequencies, and they don't know where you are.

Or they didn't, at least.

closeness: 1.

>d
You descend in wide circles, pulling mist down with you in what you hope is a sufficiently unsuspicious manner, trusting your memorization of the air currents to tell you where you're going...

Great Hall Landing Cradle
The Landing Cradle of the Great Hall spreads out over nearly a quarter of the vast building.  During your time here, you learned this was so that when a number of important guests and their retinues arrive at the same time, they can land simultaneously, instead of one after the other, which some would invariably take as meaning "in order of importance".

To the north is the Royal Quarters, the Librum to the east, {other places LS DEBUG}, and as always, you can return to the skies or descend to the forest.

You can see a leather rucksack (in which are a purple capsa of opening (in which is a scroll of rezrov), a gold capsa of FOO (closed), and a red capsa of BAR (closed)) and an important door here.

closeness: 2.
You've dived straight into a squad of Raven Guards, on their way up to accost you.  Fortunately, your speed helped you avoid most of them, but one guard's talon catches you on your side as you twist by them.

>u
High Above the Royal Aerie
Your summoned mist both obscures you and blocks you from seeing the Royal Aerie.  But you've already memorized its layout, and how it relates to today's air currents, winds, and thermals.  Royal quarters to the north, well defended by circling Raven clan guards.  The librum to the east.  {LS DEBUG: a few other rooms.  Presumably.  Kitchen, Barracks, Chapel(?), }  In the center of the Aerie (and directly below you) is the Great Hall.

closeness: 3.
The Raven Squad pursues you determinedly through the thin mist.

>d
You tuck in your wings and dive down towards the Aerie, thrilling to the misty wind streaming through your feathers.

Great Hall Landing Cradle
The Landing Cradle of the Great Hall spreads out over nearly a quarter of the vast building.  During your time here, you learned this was so that when a number of important guests and their retinues arrive at the same time, they can land simultaneously, instead of one after the other, which some would invariably take as meaning "in order of importance".

To the north is the Royal Quarters, the Librum to the east, {other places LS DEBUG}, and as always, you can return to the skies or descend to the forest.

You can see a leather rucksack (in which are a purple capsa of opening (in which is a scroll of rezrov), a gold capsa of FOO (closed), and a red capsa of BAR (closed)) and an important door here.

closeness: 3.
Your speed puts more distance between you and your pursuers, but it's not quite fast enough, or the mist isn't thick enough, or both, and your pursuers manage to keep you in sight.

>d
You tuck in your wings and dive down into the forest below the Aerie, dodging tightly-spaced trees with acrobatic precision.

In the Forest
The trees below the Royal Aerie grow more closely together than in the rest of the forest, and include a wider variety, so that differently-colored woods could be incorporated into the buildings above.  This makes it harder to navigate down here--or it would if you weren't so amazing at navigation.

Even through the mist, your sharp eyes spot a fine net, stretched between the trees.  It seems to be set to prevent anyone from coming up from the forest below.

closeness: 3.
You expertly twist at breakneck speeds, weaving through three Ash trunks, over a branch, and around and behind a Redwood, where you halt, twist, and dive straight down the trunk, out of view of any stray Raven.
The Raven's frustrated caws echo in the mist, and you plot a now-unseen course returning to the familiar currents above the Aerie.  In time, the woodpeckers cease their drumming, and the cawing fades as well.  Protocol would dictate that they return to guarding priority items, but increase patrols.

High Above the Royal Aerie
Your summoned mist both obscures you and blocks you from seeing the Royal Aerie.  But you've already memorized its layout, and how it relates to today's air currents, winds, and thermals.  Royal quarters to the north, well defended by circling Raven clan guards.  The librum to the east.  {LS DEBUG: a few other rooms.  Presumably.  Kitchen, Barracks, Chapel(?), }  In the center of the Aerie (and directly below you) is the Great Hall.

* * *

>z
Time passes.

A squad of Raven Guards appears, and their war cries exalt as they spot you.  You weave through the air, tumbling and twisting as you try to avoid them.

>u
You take to the skies even higher.

The guards charge, but you manage to evade their uncoordinated attack.

>u
You take to the skies even higher.

The guards charge, but you manage to evade their uncoordinated attack.

>summon mist
You draw even more moisture into the air, and feed it into the mist.  As it thickens, you feel safer, as you always do in the midst of clouds.

Two guards snap at you, and while both touch nothing but feathers, a third slashes you with his silvered talons.  They're about to overwhelm you.

* * *

>summon mist
Calling on your heritage as a Bostrat, you summon moisture from the air, and it slowly coalesces into a creeping grey mist, obscuring you from sight.  In gentler times, you would be doing this to ensure the growth of the fields and forests; now you must use it to hide from prying eyes that would keep you from your quarry.

You stop at the natural inflection point for clouds given today's weather.  You could make it thicker still, but it would then start to dissapate.

>showobj mist
I didn't understand that sentence.

>showme mist
(the grey mist)
grey mist - backdrop
location: in High Above the Royal Aerie
unlit, inedible, fixed in place, scenery; singular-named, improper-named
description: "Grey mist swirls and surrounds you, covering you like a blanket."
initial appearance: none
printed name: "grey mist"
printed plural name: "backdrops"
indefinite article: none
list grouping key: none
thickness: 1

>summon mist
You draw even more moisture into the air, and feed it into the mist.  As it thickens, you feel safer, as you always do in the midst of clouds.

>showme mist
(the grey mist)
grey mist - backdrop
location: in High Above the Royal Aerie
unlit, inedible, fixed in place, scenery; singular-named, improper-named
description: "Grey mist swirls and surrounds you, covering you like a blanket."
initial appearance: none
printed name: "grey mist"
printed plural name: "backdrops"
indefinite article: none
list grouping key: none
thickness: 5

>summon mist
You draw even more moisture into the air, and feed it into the mist.  As it thickens, you feel safer, as you always do in the midst of clouds.

>showme mist
(the grey mist)
grey mist - backdrop
location: in High Above the Royal Aerie
unlit, inedible, fixed in place, scenery; singular-named, improper-named
description: "Grey mist swirls and surrounds you, covering you like a blanket."
initial appearance: none
printed name: "grey mist"
printed plural name: "backdrops"
indefinite article: none
list grouping key: none
thickness: 8

>showme mist
(the grey mist)
grey mist - backdrop
location: in High Above the Royal Aerie
unlit, inedible, fixed in place, scenery; singular-named, improper-named
description: "Grey mist swirls and surrounds you, covering you like a blanket."
initial appearance: none
printed name: "grey mist"
printed plural name: "backdrops"
indefinite article: none
list grouping key: none
thickness: 8

>z
Time passes.

>summon mist
You draw even more moisture into the air, and feed it into the mist.  As it thickens, you feel safer, as you always do in the midst of clouds.

* * *

>showme mist
(the grey mist)
grey mist - backdrop
location: in High Above the Royal Aerie
unlit, inedible, fixed in place, scenery; singular-named, improper-named
description: "Grey mist swirls and surrounds you, covering you like a blanket."
initial appearance: none
printed name: "grey mist"
printed plural name: "backdrops"
indefinite article: none
list grouping key: none
thickness: 8

>summon mist
You draw even more moisture into the air, and feed it into the mist.  As it thickens, you feel safer, as you always do in the midst of clouds.

* * *

>summon mist
That's as thick as you can make the mist--there's simply no more water to pull into the air.

>summon mist
That's as thick as you can make the mist--there's simply no more water to pull into the air.

>z
Time passes.

>z
Time passes.

Your summoned mist thins slightly, on its way back to equilibrium.

* * *

>z
Time passes.

>z
Time passes.

Your summoned mist thins back to equilibrium.  Still thick enough to mostly obscure you, but you'll have to be careful.

>d
You descend in wide circles, pulling mist down with you in what you hope is a sufficiently unsuspicious manner, trusting your memorization of the air currents to tell you where you're going...

Great Hall Landing Cradle
The Landing Cradle of the Great Hall spreads out over nearly a quarter of the vast building.  During your time here, you learned this was so that when a number of important guests and their retinues arrive at the same time, they can land simultaneously, instead of one after the other, which some would invariably take as meaning "in order of importance".

To the north is the Royal Quarters, the Librum to the east, {other places LS DEBUG}, and as always, you can return to the skies.

You can see an important door here.

>u
High Above the Royal Aerie
Your summoned mist both obscures you and blocks you from seeing the Royal Aerie.  But you've already memorized its layout, and how it relates to today's air currents, winds, and thermals.  Royal quarters to the north, well defended by circling Raven clan guards.  The librum to the east.  {LS DEBUG: a few other rooms.  Presumably.  Kitchen, Barracks, Chapel(?), }  In the center of the Aerie (and directly below you) is the Great Hall.

>d
You tuck in your wings and dive down towards the Aerie, thrilling to the misty wind streaming through your feathers.

Great Hall Landing Cradle
The Landing Cradle of the Great Hall spreads out over nearly a quarter of the vast building.  During your time here, you learned this was so that when a number of important guests and their retinues arrive at the same time, they can land simultaneously, instead of one after the other, which some would invariably take as meaning "in order of importance".

To the north is the Royal Quarters, the Librum to the east, {other places LS DEBUG}, and as always, you can return to the skies.

You can see an important door here.

>d
You tuck in your wings and dive down into the forest below the Aerie, dodging tightly-spaced trees with acrobatic precision.

In the Forest
The trees below the Royal Aerie grow more closely together than in the rest of the forest, and include a wider variety, so that differently-colored woods could be incorporated into the buildings above.  This makes it harder to navigate down here--or it would if you weren't so amazing at navigation.

Even through the mist, your sharp eyes spot a fine net, stretched between the trees.  It seems to be set to prevent anyone from coming up from the forest below.

* * *

>summon mist
You draw even more moisture into the air, and feed it into the mist.  As it thickens, you feel safer, as you always do in the midst of clouds.

>z
Time passes.

Your summoned mist thins back to equilibrium.  Still thick enough to mostly obscure you, but you'll have to be careful.

>z
Time passes.

* * *

>test summon
(Testing.)

>[1] d
If you get any closer to the aerie without summoning mist first, the guards would surely see you.  It's why, as a Bostrat, you were originally chosen to go on this mission.

>[2] n
You'll need to SUMMON MIST first, to cloak your descent.

>[3] summon mist
Calling on your heritage as a Bostrat, you summon moisture from the air, and it slowly coalesces into a creeping grey mist, obscuring you from sight.  In gentler times, you would be doing this to ensure the growth of the fields and forests; now you must use it to hide from prying eyes that would keep you from your quarry.

You stop at the natural inflection point for clouds given today's weather.  You could make it thicker still, but it would then start to dissapate.

>[4] d
You descend in wide circles, pulling mist down with you in what you hope is a sufficiently unsuspicious manner, trusting your memorization of the air currents to tell you where you're going...

Great Hall Landing Cradle
The Landing Cradle of the Great Hall spreads out over nearly a quarter of the vast building.  During your time here, you learned this was so that when a number of important guests and their retinues arrive at the same time, they can land simultaneously, instead of one after the other, which some would invariably take as meaning "in order of importance".

To the north is the Royal Quarters, the Librum to the east, {other places LS DEBUG}, and as always, you can return to the skies.

You can see an important door here.

>[5] u

High Above

>[6] d

Great Hall Landing Cradle
The Landing Cradle of the Great Hall spreads out over nearly a quarter of the vast building.  During your time here, you learned this was so that when a number of important guests and their retinues arrive at the same time, they can land simultaneously, instead of one after the other, which some would invariably take as meaning "in order of importance".

To the north is the Royal Quarters, the Librum to the east, {other places LS DEBUG}, and as always, you can return to the skies.

You can see an important door here.

>[7] u

High Above

>test scenery
(Testing.)

>[1] x aerie
As you recall, the Royal Aerie was grown and shaped by generations of Throckrites, and now towers over the surrounding forest canopy.  Lush shades of browns and reds, often woven together in intricate patterns or pictures, cover every landing cradle and wall.

>[2] x royal quarters
As you recall, the Royal Quarters is where the Queen and her family, servants, and certain privileged royalty live.  Every huge common room; every small or large individual apartment is awash in greenery that looks incredibly inviting and imperially homey, and is in reality subtly precisely hostile to the uninvited.  Every roof pitch is too steep; no branch nor ridge is graspable by talons of any size.  The single landing cradle in the middle of the gardens is surrounded by stern and beautiful tree crowns, beset with nooks and crevices for unseen guards and archers: attempting to land there would mean instant death for any but those who belong.

>[3] x librum
As you recall, the Librum was your target the last time out, and where you obtained the capsas you brought back with you. Its landing cradle is simply decorated, grown with interlocking redwood and pine in a way that suggests shelves of books.  The reading nooks grown into the sides of the main building proved a reasonable entrance for a creative supplicant; no doubt that method will have been shut down by now.

>[4] x great hall
As you recall, the Great Hall is by far the largest building in the Aerie complex, and indeed the largest building you've ever seen in your life.  If the stories are true, its planning took three years, and its growth was overseen by three generations of Throckrites.  Every Royal Throckrite since has sought to put their own personal stamp on the Great Hall, leaving it more than a little haphazardly grown by now, but its current form is still impressive, even as it grows less coherent with every new modification.