Your mother needs you.  The whole village needs you.  You can do this.  You must do this.

The mantra repeats in your head, pushing you on as you wheel in circles over the forest canopy, riding thermals to heights where none but other Falcon Clan members could see you.  And there's no more Falcon Clan in the Royal Aerie--you and the rest of your clan were all banished years ago.  Three days ago, approaching from underneath worked, as none were expecting it.  But while technically successful, you failed to snatch your intended quarry: the Scroll of Health.  The sages had been unable to tell you what color capsa would hold it: you now know that it's not purple, gold, nor red.

By tonight, you will know.  You're not leaving without it.

course correction
An Interactive High Heist by Lucian Smith
Release 0 / Serial number 260224 / Inform 7 v10.1.2 / D

High Above the Royal Aerie
You drift in lazy circles well above the Royal Aerie below, safely above your quarry.  Your acute eyesight lets you see the entire layout, and how it relates to today's air currents, winds, and thermals.  Royal quarters to the north, well defended by circling Raven clan guards.  The librum to the east.  In the center of the Aerie (and directly below you) is the Great Hall.  Other royal aeries dot the forest in the distance, but this complex holds your quarry.

>d
If you get any closer to the aerie without summoning mist first, the guards would surely see you.  It's why, as a Bostrat, you were originally chosen to go on this mission.

>d
You'll need to SUMMON MIST first, to cloak your descent.

>summon mist
Calling on your heritage as a Bostrat, you summon moisture from the air, and it slowly coalesces into a creeping grey mist, obscuring you from sight.  In gentler times, you would be doing this to ensure the growth of the fields and forests; now you must use it to hide from prying eyes that would keep you from your quarry.

You stop at the natural inflection point for clouds given today's weather.  You could make it thicker still, but it would then start to dissapate.

>d
You descend in wide circles, pulling mist down with you in what you hope is a sufficiently unsuspicious manner, trusting your memorization of the air currents to tell you where you're going...

Great Hall Landing Cradle
The Landing Cradle of the Great Hall spreads out over nearly a quarter of the vast building.  During your time here, you learned this was so that when a number of important guests and their retinues arrive at the same time, they can land simultaneously, instead of one after the other, which some would invariably take as meaning "in order of importance".  The huge double doors to the Great Hall are on the west side of the landing cradle, and unguarded.

To the north is the Royal Quarters and Gardens, the Librum to the east, and as always, you can return to the skies or descend to the forest.

>d
You tuck in your wings and dive down into the forest below the Aerie, dodging tightly-spaced trees with acrobatic precision.

In the Forest
The trees below the Royal Aerie grow more closely together than in the rest of the forest, and include a wider variety, so that differently-colored woods could be incorporated into the buildings above.  This makes it harder to navigate down here--or it would if you weren't so amazing at navigation.

Even through the mist, your sharp eyes spot a fine net, stretched between the trees.  It seems to be set to prevent anyone from coming up from the forest below.

>drop gold
You haven't got that.

The momentum you had from your dive wears off.  Fun while it lasted!

>i
You are carrying:
  a leather rucksack (being worn, and open)
    a purple capsa of opening (closed)
    a gold capsa of Down (closed)
    a red capsa of hasten (closed)

>get gold
Taken.

>open gold
You open the gold capsa of Down, revealing a scroll of rudenj.

Immediately, "down" now means "towards the gold capsa" instead of "towards the earth".  Even being ready for it, it takes you a few flaps to reorient yourself, and you blink away the slight dizziness.  Then you pause.  No sounds from the Aerie.  Apparently, the new "down" is close enough to the old "down" that whatever sensors they have up there didn't detect a change.  Good.

>drop capsa
(the gold capsa of Down)
Dropped.

>u
You gracefully flit between the trees back up above the canopy.

Great Hall Landing Cradle
The Landing Cradle of the Great Hall spreads out over nearly a quarter of the vast building.  During your time here, you learned this was so that when a number of important guests and their retinues arrive at the same time, they can land simultaneously, instead of one after the other, which some would invariably take as meaning "in order of importance".  The huge double doors to the Great Hall are on the west side of the landing cradle, and unguarded.

To the north is the Royal Quarters and Gardens, the Librum to the east, and as always, you can return to the skies or descend to the forest.

>open purple
You open the purple capsa of opening, revealing a scroll of rezrov.

As you open the purple capsa, an almost-palpable wave of force emanates from it, as the power of the revealed scroll of rezrov is released.

The huge double doors to the Great Hall clicks as it unlocks!
The magic of the red capsa of hasten prevents it from being opened.
The huge double doors to the Great Hall flies open!
The straps and buckles on your rucksack fly open and it falls!

Dropped.

From... well, from everywhere in the Aerie, it seems, Woodpeckers start drumming out messages in their Pounding dialect:  "Intruder!  The enemy is DOWN. Repeat!  The enemy is DOWN."  You realize that creating a gravity well pointing straight at you might not have been the wisest move.

closeness: 1.

>u
High Above the Royal Aerie
Your summoned mist both obscures you and blocks you from seeing the Royal Aerie.  But you've already memorized its layout, and how it relates to today's air currents, winds, and thermals.  Royal quarters to the north, well defended by circling Raven clan guards.  The librum to the east.  In the center of the Aerie (and directly below you) is the Great Hall.  Other royal aeries dot the forest in the distance, but this complex holds your quarry.

closeness: 2.
You've barely left Great Hall Landing Cradle when a squad of Raven Guards wheels in from behind, hot on your tail!

>d
You tuck in your wings and dive down towards the Aerie, thrilling to the misty wind streaming through your feathers.

Great Hall Landing Cradle
The Landing Cradle of the Great Hall spreads out over nearly a quarter of the vast building.  During your time here, you learned this was so that when a number of important guests and their retinues arrive at the same time, they can land simultaneously, instead of one after the other, which some would invariably take as meaning "in order of importance".  The huge double doors to the Great Hall are on the west side of the landing cradle, and unguarded.

To the north is the Royal Quarters and Gardens, the Librum to the east, and as always, you can return to the skies or descend to the forest.

You can see a leather rucksack (in which are a purple capsa of opening (in which is a scroll of rezrov) and a red capsa of hasten (closed)) here.

closeness: 3.
As you dive, you use your knowledge of "true down" to give yourself an edge, pulling around a tree at an angle that should be impossible; diving and twisting through gaps in the  branches that couldn't be done.  Your closest pursuer crashes into a branch, and the others peel off to avoid him.

The Raven's frustrated caws echo in the mist, and you plot a now-unseen course returning to the familiar currents above the Aerie.  In time, the woodpeckers cease their drumming, and the cawing fades as well.  Protocol would dictate that they return to guarding priority items, and call up any reserves.

High Above the Royal Aerie
Your summoned mist both obscures you and blocks you from seeing the Royal Aerie.  But you've already memorized its layout, and how it relates to today's air currents, winds, and thermals.  Royal quarters to the north, well defended by circling Raven clan guards.  The librum to the east.  In the center of the Aerie (and directly below you) is the Great Hall.  Other royal aeries dot the forest in the distance, but this complex holds your quarry.

* * *

>n
If you get any closer to the aerie without summoning mist first, the guards would surely see you.  It's why, as a Bostrat, you were originally chosen to go on this mission.

>summon mist
Calling on your heritage as a Bostrat, you summon moisture from the air, and it slowly coalesces into a creeping grey mist, obscuring you from sight.  In gentler times, you would be doing this to ensure the growth of the fields and forests; now you must use it to hide from prying eyes that would keep you from your quarry.

You stop at the natural inflection point for clouds given today's weather.  You could make it thicker still, but it would then start to dissapate.

>n
You descend in wide circles, pulling mist down with you in what you hope is a sufficiently unsuspicious manner, trusting your memorization of the air currents to tell you where you're going...

Royal Gardens
The royal gardens is the most lavishly opulent and sensuous entrance to any aerie you've seen in your life.  Trees, vines, and flowers of every variety spring up from everywhere, each seemingly placed in it only appropriate spot.  The landing cradle above the Royal Quarters themselves is nestled between gracious arcs of poplar trunks, each bedecked with shaded and inviting roosts.  Which, as you know from your childhood days swooping and laughing through these gardens, invariably contain at least eight guards.

From here, you can return to the skies or descend to the forest.  The Great Hall is to the south, and the Librum to the southeast.

>x guards
The poplars around the landing cradle contain five guards that you can see (since you know where to look), and almost certainly another five that you cannot (since you know where you can't look).

>x cradle
The cradle's aesthetics have suffered somewhat from having to be re-grown every time the royal insignia changes, but it's still tastefully lavish.

>se
Librum Landing Cradle
The Landing Cradle of the Librum is beautifully set with interlocking redwood and pine, suggesting shelves of books.  The Librum Door leads inward to the Librum itself.

To the west is the Great Hall, and to the northwest is the Royal Quarters and Gardens.  You can also re-ascend to the skies or descend to the forest below.

A lone Raven guard stands in front of the door, dark eyes shifting as she watches the mist.

>x door
A canted closed hatch to the Librum, on the east side of the landing cradle.

>e
(first opening Librum Door)
The guard is entirely too watchful to let you do that.

>x guard
The raven guard wears the well-fitting uniform of the Queen's Guard, complete with a small red insignia on her shoulder.  The silvered knives on her talons are retracted while she stands, and golden razors line her beak.  Oddly, her uniform seems to be covered with... tiny closed padlocks?  That's not the insignia of any order you know.

>x uniform
Her uniform consists of loose straps, designed to fit precisely under flagfeathers and provide support while not hampering movement nor flight.  The insignia on her shoulder reads "Ikniq" under an icon of a tongue of fire: the logo of the fire warriors.

>x ikniq
Her uniform consists of loose straps, designed to fit precisely under flagfeathers and provide support while not hampering movement nor flight.  The insignia on her shoulder reads "Ikniq" under an icon of a tongue of fire: the logo of the fire warriors.

>x padlocks
Yes, those are definitely tiny padlocks, each attached to small leather loops stitched to her uniform.  You peer more intently.  The stitching where the loops attach is definitely newer than the stitching on the rest of the uniform.  They must have been added recently.

>x knives
Silvered knives, retracted now, but extendable at will.

>get knives
That seems to belong to the lone guard.

>open purple
You open the purple capsa of opening, revealing a scroll of rezrov.

As you open the purple capsa, an almost-palpable wave of force emanates from it, as the power of the revealed scroll of rezrov is released.

As the shockwave of magic reaches the guard, the padlock on her uniform closest to you pops open.  Then in succession, all the other padlocks she's wearing pop open as well, in perfect concentric circles in order of how distant they are from the scroll.  As her eyes lock with yours, you realize, somewhat belatedly, that you've given her the ability to triangulate on your position.  Without hesitation, she leaps straight at you, before you even have time to let go of the capsa.

The door behind her opens silently as she tackles you to the ground.

    *** You have been captured. ***

Would you like to RESTART, RESTORE a saved game, QUIT, or UNDO the last command?

>undo
Librum Landing Cradle
[Previous turn undone.]

>w
Great Hall Landing Cradle
The Landing Cradle of the Great Hall spreads out over nearly a quarter of the vast building.  During your time here, you learned this was so that when a number of important guests and their retinues arrive at the same time, they can land simultaneously, instead of one after the other, which some would invariably take as meaning "in order of importance".  The huge double doors to the Great Hall are on the west side of the landing cradle, and unguarded.

To the north is the Royal Quarters and Gardens, the Librum to the east, and as always, you can return to the skies or descend to the forest.

>x door
The huge double doors are canted hatches that lead from the giant landing cradle into the Great Hall itself.  They are adorned with fine scrollwork whose broad swoops and curls branch off into even finer swoops and curls, even down to the level of detail that only a Falcon Clan like yourself could see.  The Throckrian who grew this must have been an archmaster.

>x doors
The huge double doors are canted hatches that lead from the giant landing cradle into the Great Hall itself.  They are adorned with fine scrollwork whose broad swoops and curls branch off into even finer swoops and curls, even down to the level of detail that only a Falcon Clan like yourself could see.  The Throckrian who grew this must have been an archmaster.

>x cradle
The huge double doors are canted hatches that lead from the giant landing cradle into the Great Hall itself.  They are adorned with fine scrollwork whose broad swoops and curls branch off into even finer swoops and curls, even down to the level of detail that only a Falcon Clan like yourself could see.  The Throckrian who grew this must have been an archmaster.

* * *

>open red
(the red capsa of BAR)
Before you mess with powerful artifacts from the dawn of civilization, you should probably conceal yourself.  You're a Bostrat; the plan was to summon a mist.

>summon mist
Calling on your heritage as a Bostrat, you summon moisture from the air, and it slowly coalesces into a creeping grey mist, obscuring you from sight.  In gentler times, you would be doing this to ensure the growth of the fields and forests; now you must use it to hide from prying eyes that would keep you from your quarry.

You stop at the natural inflection point for clouds given today's weather.  You could make it thicker still, but it would then start to dissapate.

>open gold
You open the gold capsa of Down, revealing a scroll of rudenj.

From... well, from everywhere in the Aerie, it seems, Woodpeckers start drumming out messages in their Pounding dialect:  "Intruder!  The enemy is DOWN. Repeat!  The enemy is DOWN."  You realize that creating a gravity well pointing straight at you might not have been the wisest move.

>z
Time passes.

closeness: 1.

>z
Time passes.

closeness: 2.
A squad of Raven Guards appears, and their war cries exalt as they spot you.  You weave through the air, tumbling and twisting as you try to avoid them.

>undo
High Above the Royal Aerie
[Previous turn undone.]

>undo
High Above the Royal Aerie
[Previous turn undone.]

>l
High Above the Royal Aerie
Your summoned mist both obscures you and blocks you from seeing the Royal Aerie.  But you've already memorized its layout, and how it relates to today's air currents, winds, and thermals.  Royal quarters to the north, well defended by circling Raven clan guards.  The librum to the east.  In the center of the Aerie (and directly below you) is the Great Hall.  Other royal aeries dot the forest in the distance, but this complex holds your quarry.

>z
Time passes.

>open purple
You open the purple capsa of opening, revealing a scroll of rezrov.

As you open the purple capsa, an almost-palpable wave of force emanates from it, as the power of the revealed scroll of rezrov is released.

The magic of the gold capsa of Down prevents it from being opened.
The magic of the red capsa of BAR prevents it from being opened.
The straps and buckles on your rucksack fly open and it falls!

The leather rucksack twists away as it falls below you, towards the Great Hall.

From... well, from everywhere in the Aerie, it seems, Woodpeckers start drumming out messages in their Pounding dialect:  "Intruder! Estimated direction is..." and then each one individually seems to be telegraphing the direction from them to you.  You can't discern any one drummer from any other drummer, but you can at least tell that each seems to be drumming on sheets of metal that differ from each other, as the frequencies are all different from each other.  That makes the information somewhat useless to you, because you've not been trained to distinguish Pounding at different frequencies.  And because you already know where you are.  Sadly, the Raven Guards are indeed trained to distinguish Pounding frequencies, and they don't know where you are.

Or they didn't, at least.

closeness: 1.

>restart
Are you sure you want to restart?

>y
Your mother needs you.  The whole village needs you.  You can do this.  You must do this.

The mantra repeats in your head, pushing you on as you wheel in circles over the forest canopy, riding thermals to heights where none but other Falcon Clan members could see you.  And there's no more Falcon Clan in the Royal Aerie--you and the rest of your clan were all banished years ago.  Three days ago, approaching from underneath worked, as none were expecting it.  But while technically successful, you failed to snatch your intended quarry: the Scroll of Health.  The sages had been unable to tell you what color capsa would hold it: you now know that it's not purple, gold, nor red.

By tonight, you will know.  You're not leaving without it.

course correction
An Interactive High Heist by Lucian Smith
Release 0 / Serial number 260224 / Inform 7 v10.1.2 / D

High Above the Royal Aerie
You drift in lazy circles well above the Royal Aerie below, safely above your quarry.  Your acute eyesight lets you see the entire layout, and how it relates to today's air currents, winds, and thermals.  Royal quarters to the north, well defended by circling Raven clan guards.  The librum to the east.  In the center of the Aerie (and directly below you) is the Great Hall.  Other royal aeries dot the forest in the distance, but this complex holds your quarry.

>open gold
Before you mess with powerful artifacts from the dawn of civilization, you should probably conceal yourself.  You're a Bostrat; the plan was to summon a mist.

>summon mist
Calling on your heritage as a Bostrat, you summon moisture from the air, and it slowly coalesces into a creeping grey mist, obscuring you from sight.  In gentler times, you would be doing this to ensure the growth of the fields and forests; now you must use it to hide from prying eyes that would keep you from your quarry.

You stop at the natural inflection point for clouds given today's weather.  You could make it thicker still, but it would then start to dissapate.

* * *

>summon mist
Calling on your heritage as a Bostrat, you summon moisture from the air, and it slowly coalesces into a creeping grey mist, obscuring you from sight.  In gentler times, you would be doing this to ensure the growth of the fields and forests; now you must use it to hide from prying eyes that would keep you from your quarry.

You stop at the natural inflection point for clouds given today's weather.  You could make it thicker still, but it would then start to dissapate.

>d
You descend in wide circles, pulling mist down with you in what you hope is a sufficiently unsuspicious manner, trusting your memorization of the air currents to tell you where you're going...

Great Hall Landing Cradle
The Landing Cradle of the Great Hall spreads out over nearly a quarter of the vast building.  During your time here, you learned this was so that when a number of important guests and their retinues arrive at the same time, they can land simultaneously, instead of one after the other, which some would invariably take as meaning "in order of importance".

To the north is the Royal Quarters, the Librum to the east, and as always, you can return to the skies or descend to the forest.

You can see an important door here.

>e
Librum Landing Cradle
The Landing Cradle of the Librum is beautifully set with interlocking redwood and pine, suggesting shelves of books.  The Librum Door leads inward to the Librum itself.

To the west is the Great Hall, and to the northwest is the Royal Quarters.  You can also re-ascend to the skies or descend to the forest below.

A lone Raven guard stands in front of the door, dark eyes shifting as she watches the mist.

>d
You tuck in your wings and dive down into the forest below the Aerie, dodging tightly-spaced trees with acrobatic precision.

In the Forest
The trees below the Royal Aerie grow more closely together than in the rest of the forest, and include a wider variety, so that differently-colored woods could be incorporated into the buildings above.  This makes it harder to navigate down here--or it would if you weren't so amazing at navigation.

Even through the mist, your sharp eyes spot a fine net, stretched between the trees.  It seems to be set to prevent anyone from coming up from the forest below.

>u
You gracefully flit between the trees back up above the canopy.

Great Hall Landing Cradle
The Landing Cradle of the Great Hall spreads out over nearly a quarter of the vast building.  During your time here, you learned this was so that when a number of important guests and their retinues arrive at the same time, they can land simultaneously, instead of one after the other, which some would invariably take as meaning "in order of importance".

To the north is the Royal Quarters, the Librum to the east, and as always, you can return to the skies or descend to the forest.

You can see an important door here.

The momentum you had from your dive wears off.  Fun while it lasted!

>e
Librum Landing Cradle
The Landing Cradle of the Librum is beautifully set with interlocking redwood and pine, suggesting shelves of books.  The Librum Door leads inward to the Librum itself.

To the west is the Great Hall, and to the northwest is the Royal Quarters.  You can also re-ascend to the skies or descend to the forest below.

A lone Raven guard stands in front of the door, dark eyes shifting as she watches the mist.

>e
(first opening Librum Door)
The guard is entirely too watchful to let you do that.

>in
(first opening Librum Door)
The guard is entirely too watchful to let you do that.

>open door
The guard is entirely too watchful to let you do that.

>unlock door
(with the leather rucksack)
The guard is entirely too watchful to let you do that.

* * *

>summon mist
Calling on your heritage as a Bostrat, you summon moisture from the air, and it slowly coalesces into a creeping grey mist, obscuring you from sight.  In gentler times, you would be doing this to ensure the growth of the fields and forests; now you must use it to hide from prying eyes that would keep you from your quarry.

You stop at the natural inflection point for clouds given today's weather.  You could make it thicker still, but it would then start to dissapate.

>open gold
You open the gold capsa of Down, revealing a scroll of rudenj.

From... well, from everywhere in the Aerie, it seems, Woodpeckers start drumming out messages in their Pounding dialect:  "Intruder!  The enemy is DOWN. Repeat!  The enemy is DOWN."  You realize that creating a gravity well pointing straight at you might not have been the wisest move.

closeness: 1.

>undo
High Above the Royal Aerie
[Previous turn undone.]

>open purple
You open the purple capsa of opening, revealing a scroll of rezrov.

As you open the purple capsa, an almost-palpable wave of force emanates from it, as the power of the revealed scroll of rezrov is released.

The magic of the gold capsa of Down prevents it from being opened.
The magic of the red capsa of BAR prevents it from being opened.
The straps and buckles on your rucksack fly open and it falls!

The leather rucksack twists away as it falls below you, towards the Great Hall.

From... well, from everywhere in the Aerie, it seems, Woodpeckers start drumming out messages in their Pounding dialect:  "Intruder! Estimated direction is..." and then each one individually seems to be telegraphing the direction from them to you.  You can't discern any one drummer from any other drummer, but you can at least tell that each seems to be drumming on sheets of metal that differ from each other, as the frequencies are all different from each other.  That makes the information somewhat useless to you, because you've not been trained to distinguish Pounding at different frequencies.  And because you already know where you are.  Sadly, the Raven Guards are indeed trained to distinguish Pounding frequencies, and they don't know where you are.

Or they didn't, at least.

closeness: 1.

>close purple
You can't see any such thing.

>d
You descend in wide circles, pulling mist down with you in what you hope is a sufficiently unsuspicious manner, trusting your memorization of the air currents to tell you where you're going...

Great Hall Landing Cradle
The Landing Cradle of the Great Hall spreads out over nearly a quarter of the vast building.  During your time here, you learned this was so that when a number of important guests and their retinues arrive at the same time, they can land simultaneously, instead of one after the other, which some would invariably take as meaning "in order of importance".  The huge double doors to the Great Hall are on the west side of the landing cradle, and unguarded.

To the north is the Royal Quarters and Gardens, the Librum to the east, and as always, you can return to the skies or descend to the forest.

You can see a leather rucksack (in which are a purple capsa of opening (in which is a scroll of rezrov), a gold capsa of Down (closed), and a red capsa of BAR (closed)) here.

closeness: 2.
You've dived straight into a squad of Raven Guards, on their way up to accost you.  Fortunately, your speed helped you avoid most of them, but one guard's talon catches you on your side as you twist by them.

>close purple
You close the purple capsa of opening.

You feel your skin prickle where you were wounded, and look down.  To your amazement, your wound has closed and the bleeding stopped.  As you watch, even the line from the cut disappears, and the feathers around it fluff out again.

It's the scroll of Health.  It has to be.  It's actually here!  And active.  Hmm.

closeness: 3.
The guards charge, but you manage to evade their uncoordinated attack.

* * *

>summon mist
Calling on your heritage as a Bostrat, you summon moisture from the air, and it slowly coalesces into a creeping grey mist, obscuring you from sight.  In gentler times, you would be doing this to ensure the growth of the fields and forests; now you must use it to hide from prying eyes that would keep you from your quarry.

You stop at the natural inflection point for clouds given today's weather.  You could make it thicker still, but it would then start to dissapate.

>open haste
You open the red capsa of hasten, revealing a scroll of quiste.

From everywhere in the Aerie, you hear the drumming of Woodpeckers in the Pounding dialect:  "Target is quick, repeat target is quick.  Remember you are too."  Fortunately, it doesn't seem like they were able to triangulate on you.  Now you just have to be good at being faster than normal, against others who are also faster than normal, and who have had months to practice being fast.  No problem.

>d
You descend in wide circles, pulling mist down with you in what you hope is a sufficiently unsuspicious manner, trusting your memorization of the air currents to tell you where you're going...

Great Hall Landing Cradle
The Landing Cradle of the Great Hall spreads out over nearly a quarter of the vast building.  During your time here, you learned this was so that when a number of important guests and their retinues arrive at the same time, they can land simultaneously, instead of one after the other, which some would invariably take as meaning "in order of importance".  The huge double doors to the Great Hall are on the west side of the landing cradle, and unguarded.

To the north is the Royal Quarters and Gardens, the Librum to the east, and as always, you can return to the skies or descend to the forest.

>u
High Above the Royal Aerie
Your summoned mist both obscures you and blocks you from seeing the Royal Aerie.  But you've already memorized its layout, and how it relates to today's air currents, winds, and thermals.  Royal quarters to the north, well defended by circling Raven clan guards.  The librum to the east.  In the center of the Aerie (and directly below you) is the Great Hall.  Other royal aeries dot the forest in the distance, but this complex holds your quarry.

>d
You dive blindingly fast towards the Aerie through the fog, and the mist swallows you with nary an eddy.

Great Hall Landing Cradle
The Landing Cradle of the Great Hall spreads out over nearly a quarter of the vast building.  During your time here, you learned this was so that when a number of important guests and their retinues arrive at the same time, they can land simultaneously, instead of one after the other, which some would invariably take as meaning "in order of importance".  The huge double doors to the Great Hall are on the west side of the landing cradle, and unguarded.

To the north is the Royal Quarters and Gardens, the Librum to the east, and as always, you can return to the skies or descend to the forest.

>d
Your wings tighten close to your body as you rocket through the mist, your keen eyesight only barely enough to keep you from crashing into branches and trees.

It is, without a doubt, the most thrilling dive of your entire life.

At the last second, you flare your wings, and feel like they're about to rip off of your shoulders.  You skim over the netting, your curved talons juddering across the lines, making your whole body tremble until you pull up again to dodge more tree trunks.  You allow yourself a triumphant cry, safe in the knowledge that nobody could catch you at these speeds.  Nobody.

In the Forest
The trees below the Royal Aerie grow more closely together than in the rest of the forest, and include a wider variety, so that differently-colored woods could be incorporated into the buildings above.  This makes it harder to navigate down here--or it would if you weren't so amazing at navigation.

Even through the mist, your sharp eyes spot a fine net, stretched between the trees.  It seems to be set to prevent anyone from coming up from the forest below.

>u
You gracefully flit between the trees back up above the canopy.

Great Hall Landing Cradle
The Landing Cradle of the Great Hall spreads out over nearly a quarter of the vast building.  During your time here, you learned this was so that when a number of important guests and their retinues arrive at the same time, they can land simultaneously, instead of one after the other, which some would invariably take as meaning "in order of importance".  The huge double doors to the Great Hall are on the west side of the landing cradle, and unguarded.

To the north is the Royal Quarters and Gardens, the Librum to the east, and as always, you can return to the skies or descend to the forest.

>u
High Above the Royal Aerie
Your summoned mist both obscures you and blocks you from seeing the Royal Aerie.  But you've already memorized its layout, and how it relates to today's air currents, winds, and thermals.  Royal quarters to the north, well defended by circling Raven clan guards.  The librum to the east.  In the center of the Aerie (and directly below you) is the Great Hall.  Other royal aeries dot the forest in the distance, but this complex holds your quarry.

The momentum you had from your dive wears off.  Fun while it lasted!

>d
You dive blindingly fast towards the Aerie through the fog, and the mist swallows you with nary an eddy.

Great Hall Landing Cradle
The Landing Cradle of the Great Hall spreads out over nearly a quarter of the vast building.  During your time here, you learned this was so that when a number of important guests and their retinues arrive at the same time, they can land simultaneously, instead of one after the other, which some would invariably take as meaning "in order of importance".  The huge double doors to the Great Hall are on the west side of the landing cradle, and unguarded.

To the north is the Royal Quarters and Gardens, the Librum to the east, and as always, you can return to the skies or descend to the forest.

>d
Your wings tighten close to your body as you rocket through the mist, your keen eyesight only barely enough to keep you from crashing into branches and trees.

In the Forest
The trees below the Royal Aerie grow more closely together than in the rest of the forest, and include a wider variety, so that differently-colored woods could be incorporated into the buildings above.  This makes it harder to navigate down here--or it would if you weren't so amazing at navigation.

Even through the mist, your sharp eyes spot a fine net, stretched between the trees.  It seems to be set to prevent anyone from coming up from the forest below.

>u
You gracefully flit between the trees back up above the canopy.

Great Hall Landing Cradle
The Landing Cradle of the Great Hall spreads out over nearly a quarter of the vast building.  During your time here, you learned this was so that when a number of important guests and their retinues arrive at the same time, they can land simultaneously, instead of one after the other, which some would invariably take as meaning "in order of importance".  The huge double doors to the Great Hall are on the west side of the landing cradle, and unguarded.

To the north is the Royal Quarters and Gardens, the Librum to the east, and as always, you can return to the skies or descend to the forest.

>open purple
You open the purple capsa of opening, revealing a scroll of rezrov.

As you open the purple capsa, an almost-palpable wave of force emanates from it, as the power of the revealed scroll of rezrov is released.

The huge double doors to the Great Hall clicks as it unlocks!
The magic of the gold capsa of Down prevents it from being opened.
The huge double doors to the Great Hall flies open!
The straps and buckles on your rucksack fly open and it falls!

Dropped.

From... well, from everywhere in the Aerie, it seems, Woodpeckers start drumming out messages in their Pounding dialect:  "Intruder! Estimated direction is..." and then each one individually seems to be telegraphing the direction from them to you.  You can't discern any one drummer from any other drummer, but you can at least tell that each seems to be drumming on sheets of metal that differ from each other, as the frequencies are all different from each other.  That makes the information somewhat useless to you, because you've not been trained to distinguish Pounding at different frequencies.  And because you already know where you are.  Sadly, the Raven Guards are indeed trained to distinguish Pounding frequencies, and they don't know where you are.

Or they didn't, at least.

closeness: 1.

The momentum you had from your dive wears off.

>u
High Above the Royal Aerie
Your summoned mist both obscures you and blocks you from seeing the Royal Aerie.  But you've already memorized its layout, and how it relates to today's air currents, winds, and thermals.  Royal quarters to the north, well defended by circling Raven clan guards.  The librum to the east.  In the center of the Aerie (and directly below you) is the Great Hall.  Other royal aeries dot the forest in the distance, but this complex holds your quarry.

closeness: 2.
You've barely left Great Hall Landing Cradle when a squad of Raven Guards wheels in from behind, hot on your tail!

>z
Time passes.

closeness: 3.
The guards charge, but you manage to evade their uncoordinated attack.

>z
Time passes.

closeness: 4.
Two guards snap at you, and while both touch nothing but feathers, a third slashes you with his silvered talons.  They're about to overwhelm you.

>scenes
Scene 'Entire Game' playing (for 15 mins now)
Scene 'Starting Off' ended
Scene 'Everything Is Open' playing (for 4 mins now)
Scene 'Go go go' playing (for 14 mins now)
Scene 'Momentum' ended
Scene 'Super-momentum' ended
Scene 'Being Chased' playing (for 4 mins now)
Scene 'Not Recovering' playing (for 0 mins now)
(Scene monitoring now switched on. Type "scenes off" to switch it off again.)

>showme woodpeckers
Woodpeckers - person
location: in the Void
unlit, inedible, portable; transparent, male; singular-named, proper-named; activated
description: "I dunno if you'll ever actually see these guys; they just sound the alarms from offstage."
initial appearance: none
carrying capacity: 100
printed name: "Woodpeckers"
printed plural name: "people"
indefinite article: none
list grouping key: none
reset state: 0

>d
You dive blindingly fast towards the Aerie through the fog, and the mist swallows you with nary an eddy.

Great Hall Landing Cradle
The Landing Cradle of the Great Hall spreads out over nearly a quarter of the vast building.  During your time here, you learned this was so that when a number of important guests and their retinues arrive at the same time, they can land simultaneously, instead of one after the other, which some would invariably take as meaning "in order of importance".  The huge double doors to the Great Hall are on the west side of the landing cradle, and unguarded.

To the north is the Royal Quarters and Gardens, the Librum to the east, and as always, you can return to the skies or descend to the forest.

You can see a leather rucksack (in which are a purple capsa of opening (in which is a scroll of rezrov), a gold capsa of Down (closed), and a red capsa of hasten (in which is a scroll of quiste)) here.

[Scene 'Super-momentum' begins]
closeness: 5.
You expertly twist at breakneck speeds, weaving through three Ash trunks, over a branch, and around and behind a Redwood, where you halt, twist, and dive straight down the trunk, out of view of any stray Raven.

The Raven's frustrated caws echo in the mist, and you plot a now-unseen course returning to the familiar currents above the Aerie.  In time, the woodpeckers cease their drumming, and the cawing fades as well.  Protocol would dictate that they return to guarding priority items, but increase patrols.

High Above the Royal Aerie
Your summoned mist both obscures you and blocks you from seeing the Royal Aerie.  But you've already memorized its layout, and how it relates to today's air currents, winds, and thermals.  Royal quarters to the north, well defended by circling Raven clan guards.  The librum to the east.  In the center of the Aerie (and directly below you) is the Great Hall.  Other royal aeries dot the forest in the distance, but this complex holds your quarry.

[Scene 'Being Chased' ends]

* * *

>summon mist
Calling on your heritage as a Bostrat, you summon moisture from the air, and it slowly coalesces into a creeping grey mist, obscuring you from sight.  In gentler times, you would be doing this to ensure the growth of the fields and forests; now you must use it to hide from prying eyes that would keep you from your quarry.

You stop at the natural inflection point for clouds given today's weather.  You could make it thicker still, but it would then start to dissapate.

>summon mist
You draw even more moisture into the air, and feed it into the mist.  As it thickens, you feel safer, as you always do in the midst of clouds.

>summon mist
You draw even more moisture into the air, and feed it into the mist.  As it thickens, you feel safer, as you always do in the midst of clouds.

>summon mist
That's as thick as you can make the mist--there's simply no more water to pull into the air.

>open purple
You open the purple capsa of opening, revealing a scroll of rezrov.

As you open the purple capsa, an almost-palpable wave of force emanates from it, as the power of the revealed scroll of rezrov is released.

The magic of the gold capsa of Down prevents it from being opened.
The magic of the red capsa of hasten prevents it from being opened.
The straps and buckles on your rucksack fly open and it falls!

The leather rucksack twists away as it falls below you, towards the Great Hall.

>e
You descend in wide circles, pulling mist down with you in what you hope is a sufficiently unsuspicious manner, trusting your memorization of the air currents to tell you where you're going...

Librum Landing Cradle
The Landing Cradle of the Librum is beautifully set with interlocking redwood and pine, suggesting shelves of books.  The Librum Door leads inward to the Librum itself.

To the west is the Great Hall, and to the northwest is the Royal Quarters and Gardens.  You can also re-ascend to the skies or descend to the forest below.

A lone Raven guard stands in front of the door, dark eyes shifting as she watches the mist.

Your summoned mist thins slightly, on its way back to equilibrium.

>d
You tuck in your wings and dive down into the forest below the Aerie, dodging tightly-spaced trees with acrobatic precision.

In the Forest
The trees below the Royal Aerie grow more closely together than in the rest of the forest, and include a wider variety, so that differently-colored woods could be incorporated into the buildings above.  This makes it harder to navigate down here--or it would if you weren't so amazing at navigation.

Even through the mist, your sharp eyes spot a fine net, stretched between the trees.  It seems to be set to prevent anyone from coming up from the forest below.

>u
You gracefully flit between the trees back up above the canopy.

Great Hall Landing Cradle
The Landing Cradle of the Great Hall spreads out over nearly a quarter of the vast building.  During your time here, you learned this was so that when a number of important guests and their retinues arrive at the same time, they can land simultaneously, instead of one after the other, which some would invariably take as meaning "in order of importance".  The huge double doors to the Great Hall are on the west side of the landing cradle, and unguarded.

To the north is the Royal Quarters and Gardens, the Librum to the east, and as always, you can return to the skies or descend to the forest.

You can see a leather rucksack (in which are a purple capsa of opening (in which is a scroll of rezrov), a gold capsa of Down (closed), and a red capsa of hasten (closed)) here.

The momentum you had from your dive wears off.  Fun while it lasted!

>u
High Above the Royal Aerie
Your summoned mist both obscures you and blocks you from seeing the Royal Aerie.  But you've already memorized its layout, and how it relates to today's air currents, winds, and thermals.  Royal quarters to the north, well defended by circling Raven clan guards.  The librum to the east.  In the center of the Aerie (and directly below you) is the Great Hall.  Other royal aeries dot the forest in the distance, but this complex holds your quarry.

Your summoned mist thins slightly, on its way back to equilibrium.

>d
You tuck in your wings and dive down towards the Aerie, thrilling to the misty wind streaming through your feathers.

Great Hall Landing Cradle
The Landing Cradle of the Great Hall spreads out over nearly a quarter of the vast building.  During your time here, you learned this was so that when a number of important guests and their retinues arrive at the same time, they can land simultaneously, instead of one after the other, which some would invariably take as meaning "in order of importance".  The huge double doors to the Great Hall are on the west side of the landing cradle, and unguarded.

To the north is the Royal Quarters and Gardens, the Librum to the east, and as always, you can return to the skies or descend to the forest.

You can see a leather rucksack (in which are a purple capsa of opening (in which is a scroll of rezrov), a gold capsa of Down (closed), and a red capsa of hasten (closed)) here.

>d
You tuck in your wings and dive down into the forest below the Aerie, dodging tightly-spaced trees with acrobatic precision.

In the Forest
The trees below the Royal Aerie grow more closely together than in the rest of the forest, and include a wider variety, so that differently-colored woods could be incorporated into the buildings above.  This makes it harder to navigate down here--or it would if you weren't so amazing at navigation.

Even through the mist, your sharp eyes spot a fine net, stretched between the trees.  It seems to be set to prevent anyone from coming up from the forest below.

>d
The net prevents you from reaching the forest floor.  Fortunately, you're already where you want to be.

Your summoned mist thins slightly, on its way back to equilibrium.

>get rucksack
You can't see any such thing.

>e
You gracefully flit between the trees back up above the canopy.

Librum Landing Cradle
The Landing Cradle of the Librum is beautifully set with interlocking redwood and pine, suggesting shelves of books.  The Librum Door leads inward to the Librum itself.

To the west is the Great Hall, and to the northwest is the Royal Quarters and Gardens.  You can also re-ascend to the skies or descend to the forest below.

A lone Raven guard stands in front of the door, dark eyes shifting as she watches the mist.

>close purple
You can't see any such thing.

>z
Time passes.

The momentum you had from your dive wears off.  Fun while it lasted!

>z
Time passes.

Your summoned mist thins slightly, on its way back to equilibrium.

>z
Time passes.

>open purple
You can't see any such thing.

>u
High Above the Royal Aerie
Your summoned mist both obscures you and blocks you from seeing the Royal Aerie.  But you've already memorized its layout, and how it relates to today's air currents, winds, and thermals.  Royal quarters to the north, well defended by circling Raven clan guards.  The librum to the east.  In the center of the Aerie (and directly below you) is the Great Hall.  Other royal aeries dot the forest in the distance, but this complex holds your quarry.

Your summoned mist thins back to equilibrium.  Still thick enough to mostly obscure you, but you'll have to be careful.

>d
You tuck in your wings and dive down towards the Aerie, thrilling to the misty wind streaming through your feathers.

Great Hall Landing Cradle
The Landing Cradle of the Great Hall spreads out over nearly a quarter of the vast building.  During your time here, you learned this was so that when a number of important guests and their retinues arrive at the same time, they can land simultaneously, instead of one after the other, which some would invariably take as meaning "in order of importance".  The huge double doors to the Great Hall are on the west side of the landing cradle, and unguarded.

To the north is the Royal Quarters and Gardens, the Librum to the east, and as always, you can return to the skies or descend to the forest.

You can see a leather rucksack (in which are a purple capsa of opening (in which is a scroll of rezrov), a gold capsa of Down (closed), and a red capsa of hasten (closed)) here.

>get rucksack
Taken.

The momentum you had from your dive wears off.  Fun while it lasted!

>e
Librum Landing Cradle
The Landing Cradle of the Librum is beautifully set with interlocking redwood and pine, suggesting shelves of books.  The Librum Door leads inward to the Librum itself.

To the west is the Great Hall, and to the northwest is the Royal Quarters and Gardens.  You can also re-ascend to the skies or descend to the forest below.

A lone Raven guard stands in front of the door, dark eyes shifting as she watches the mist.

>x door
A canted open hatch to the Librum, on the east side of the landing cradle.

>close purple
You close the purple capsa of opening.

The guard closes the Librum door.

>z
Time passes.

The guard locks the Librum door.

>z
Time passes.

>open purple
You open the purple capsa of opening, revealing a scroll of rezrov.

As you open the purple capsa, an almost-palpable wave of force emanates from it, as the power of the revealed scroll of rezrov is released.

As the shockwave of magic reaches the guard, the padlock on her uniform closest to you pops open.  Then in succession, all the other padlocks she's wearing pop open as well, in perfect concentric circles in order of how distant they are from the scroll.  As her eyes lock with yours, you realize, somewhat belatedly, that you've given her the ability to triangulate on your position.  Without hesitation, she leaps straight at you, before you even have time to let go of the capsa.

The door behind her opens silently as she tackles you to the ground.

    *** You have been captured. ***

Would you like to RESTART, RESTORE a saved game, QUIT, or UNDO the last command?

* * *

>undo
Librum Landing Cradle
[Previous turn undone.]

>showme tiny closed
Tiny closed padlocks - thing
location: part of the well-fitting uniform worn by the lone guard in Librum Landing Cradle
unlit, inedible, portable; singular-named, proper-named
description: "Yes, those are definitely tiny padlocks, each attached to small leather loops stitched to her uniform.  You peer more intently.  The stitching where the loops attach is definitely newer than the stitching on the rest of the uniform.  They must have been added recently."
initial appearance: none
printed name: "Tiny closed padlocks"
printed plural name: none
indefinite article: none
list grouping key: none

* * *

>test chase_start_down
(Testing.)

>[1] open purple
You open the purple capsa of opening, revealing a scroll of rezrov.

As you open the purple capsa, an almost-palpable wave of force emanates from it, as the power of the revealed scroll of rezrov is released.

The magic of the gold capsa of FOO prevents it from being opened.
The magic of the red capsa of BAR prevents it from being opened.
The straps and buckles on your rucksack fly open and it falls!

The leather rucksack twists away as it falls below you, towards the Great Hall.

From... well, from everywhere in the Aerie, it seems, Woodpeckers start drumming out messages in their Pounding dialect:  "Intruder! Estimated direction is..." and then each one individually seems to be telegraphing the direction from them to you.  You can't discern any one drummer from any other drummer, but you can at least tell that each seems to be drumming on sheets of metal that differ from each other, as the frequencies are all different from each other.  That makes the information somewhat useless to you, because you've not been trained to distinguish Pounding at different frequencies.  And because you already know where you are.  Sadly, the Raven Guards are indeed trained to distinguish Pounding frequencies, and they don't know where you are.

Or they didn't, at least.

closeness: 1.

>[2] e
You tuck in your wings and dive down towards the Aerie, thrilling to the misty wind streaming through your feathers.

Librum Landing Cradle
The Landing Cradle of the Librum is beautifully set with interlocking redwood and pine, suggesting shelves of books.  The Librum Door leads inward to the Librum itself.

To the west is the Great Hall, and to the northwest is the Royal Quarters.  You can also re-ascend to the skies or descend to the forest below.

closeness: 2.
You've dived straight into a squad of Raven Guards, on their way up to accost you.  Fortunately, your speed helped you avoid most of them, but one guard's talon catches you on your side as you twist by them.

>[3] nw

Royal Landing Cradle
It's dangerous; you can't do anything here yet. LS DEBUG.  (you can go south, southeast, up, down)

closeness: 3.
Your speed puts more distance between you and your pursuers, but it's not quite fast enough, or the mist isn't thick enough, or both, and your pursuers manage to keep you in sight.

The momentum you had from your dive wears off.  
>[4] u

High Above the Royal Aerie
Your summoned mist both obscures you and blocks you from seeing the Royal Aerie.  But you've already memorized its layout, and how it relates to today's air currents, winds, and thermals.  Royal quarters to the north, well defended by circling Raven clan guards.  The librum to the east.  In the center of the Aerie (and directly below you) is the Great Hall.  Other royal aeries dot the forest in the distance, but this complex holds your quarry.

closeness: 3.
The Raven Squad pursues you determinedly through the thin mist.

* * *

>test chase_ustart
(Testing.)

>[1] open purple
You open the purple capsa of opening, revealing a scroll of rezrov.

As you open the purple capsa, an almost-palpable wave of force emanates from it, as the power of the revealed scroll of rezrov is released.

The magic of the gold capsa of FOO prevents it from being opened.
The magic of the red capsa of BAR prevents it from being opened.
The straps and buckles on your rucksack fly open and it falls!

The leather rucksack twists away as it falls below you, towards the Great Hall.

From... well, from everywhere in the Aerie, it seems, Woodpeckers start drumming out messages in their Pounding dialect:  "Intruder! Estimated direction is..." and then each one individually seems to be telegraphing the direction from them to you.  You can't discern any one drummer from any other drummer, but you can at least tell that each seems to be drumming on sheets of metal that differ from each other, as the frequencies are all different from each other.  That makes the information somewhat useless to you, because you've not been trained to distinguish Pounding at different frequencies.  And because you already know where you are.  Sadly, the Raven Guards are indeed trained to distinguish Pounding frequencies, and they don't know where you are.

Or they didn't, at least.

closeness: 1.

>[2] e
You tuck in your wings and dive down towards the Aerie, thrilling to the misty wind streaming through your feathers.

Librum Landing Cradle
The Landing Cradle of the Librum is beautifully set with interlocking redwood and pine, suggesting shelves of books.  The Librum Door leads inward to the Librum itself.

To the west is the Great Hall, and to the northwest is the Royal Quarters.  You can also re-ascend to the skies or descend to the forest below.

closeness: 2.
You've dived straight into a squad of Raven Guards, on their way up to accost you.  Fortunately, your speed helped you avoid most of them, but one guard's talon catches you on your side as you twist by them.

>[3] nw

Royal Landing Cradle
It's dangerous; you can't do anything here yet. LS DEBUG.  (you can go south, southeast, up, down)

closeness: 3.
Your speed puts more distance between you and your pursuers, but it's not quite fast enough, or the mist isn't thick enough, or both, and your pursuers manage to keep you in sight.

The momentum you had from your dive wears off.  
>[4] u

High Above the Royal Aerie
Your summoned mist both obscures you and blocks you from seeing the Royal Aerie.  But you've already memorized its layout, and how it relates to today's air currents, winds, and thermals.  Royal quarters to the north, well defended by circling Raven clan guards.  The librum to the east.  In the center of the Aerie (and directly below you) is the Great Hall.  Other royal aeries dot the forest in the distance, but this complex holds your quarry.

closeness: 3.
The Raven Squad pursues you determinedly through the thin mist.