># typo: 'rapid'
Noted.

>#typo: 'rapid'
I didn't understand that sentence.

* * *

>#check
(changed to "# check")
Noted.

* * *

>d
You'll need to SUMMON MIST first, to cloak your descent.

>summon mist
Calling on your heritage as a Bostrat, you summon moisture from the air, and it slowly coalesces into a creeping grey mist, obscuring you from sight.  In gentler times, you would be doing this to ensure the growth of the fields and forests; now you must use it to hide from prying eyes that would keep you from your quarry.

>d
You descend, bringing mist with you, and trusting your memorization of the air currents to tell you where you're going...

Great Hall Landing Cradle
The Landing Cradle of the Great Hall spreads out over nearly a quarter of the vast building.  During your time here, you learned this was so that when a number of important guests and their retinues arrive at the same time, they can land simultaneously, instead of one after the other, which some would invariably take as meaning "in order of importance".

To the north is the Royal Quarters, the Librum to the east, {other places LS DEBUG}, and as always, you can return to the skies.

You can see an important door here.

>in
(first opening the important door)
It seems to be locked.

>e
Librum Landing Cradle
The Landing Cradle of the Librum is beautifully set with interlocking redwood and pine, suggesting shelves of books.  {Probably be more descriptive here LS DEBUG}.

To the west is the Great Hall, and to the northwest is the Royal Quarters.

You can see Another Important Door here.

>in
(first opening Another Important Door)
It seems to be locked.

>u
High Above the Royal Aerie
Your summoned mist both obscures you and blocks you from seeing the Royal Aerie.  But you've already memorized its layout, and how it relates to today's air currents, winds, and thermals.  Royal quarters to the north, well defended by circling Raven clan guards.  The librum to the east.  {LS DEBUG: a few other rooms.  Presumably.  Kitchen, Barracks, Chapel(?), }  In the center of the Aerie (and directly below you) is the Great Hall.

>d
You descend, bringing mist with you, and trusting your memorization of the air currents to tell you where you're going...

Great Hall Landing Cradle
The Landing Cradle of the Great Hall spreads out over nearly a quarter of the vast building.  During your time here, you learned this was so that when a number of important guests and their retinues arrive at the same time, they can land simultaneously, instead of one after the other, which some would invariably take as meaning "in order of importance".

To the north is the Royal Quarters, the Librum to the east, {other places LS DEBUG}, and as always, you can return to the skies.

You can see an important door here.

>n
Royal Landing Cradle
It's dangerous; you can't do anything here yet. LS DEBUG.  (you can go south, southeast, up)

>se
Librum Landing Cradle
The Landing Cradle of the Librum is beautifully set with interlocking redwood and pine, suggesting shelves of books.  {Probably be more descriptive here LS DEBUG}.

To the west is the Great Hall, and to the northwest is the Royal Quarters.

You can see Another Important Door here.

>enter door
(first opening Another Important Door)
It seems to be locked.

>open purple
As you open the purple capsa, an almost-palpable wave of force emanates from it, as the power of the revealed scroll of rezrov is released.
Another Important Door clicks as it unlocks!
Another Important Door flies open!
The straps and buckles on your rucksack fly open and it falls!

Dropped.

Also, you alert everyone to your presence, and they start heading straight for you.  Fortunately, they are, as of yet, unimplemented.  LS DEBUG.

>w
Great Hall Landing Cradle
The Landing Cradle of the Great Hall spreads out over nearly a quarter of the vast building.  During your time here, you learned this was so that when a number of important guests and their retinues arrive at the same time, they can land simultaneously, instead of one after the other, which some would invariably take as meaning "in order of importance".

To the north is the Royal Quarters, the Librum to the east, {other places LS DEBUG}, and as always, you can return to the skies.

You can see an important door here.

>x door
You see nothing special about the important door.

>enter door
Upper Great Hall
Congrats!  This is as far as I got.  Thanks for testing!

You can see an important door here.

>close door
Try as you might, a mystical force prevents you from closing the important door.

>i
You are carrying nothing.

>out
Great Hall Landing Cradle
The Landing Cradle of the Great Hall spreads out over nearly a quarter of the vast building.  During your time here, you learned this was so that when a number of important guests and their retinues arrive at the same time, they can land simultaneously, instead of one after the other, which some would invariably take as meaning "in order of importance".

To the north is the Royal Quarters, the Librum to the east, {other places LS DEBUG}, and as always, you can return to the skies.

You can see an important door here.

>e
Librum Landing Cradle
The Landing Cradle of the Librum is beautifully set with interlocking redwood and pine, suggesting shelves of books.  {Probably be more descriptive here LS DEBUG}.

To the west is the Great Hall, and to the northwest is the Royal Quarters.

You can see a leather rucksack (in which are a purple capsa of rezrov (in which is a scroll of rezrov), a gold capsa of FOO (closed), and a red capsa of BAR (closed)) and Another Important Door here.

>get rucksack
Taken.

>close it
Try as you might, a mystical force prevents you from closing the leather rucksack.

>wear it
A mystical force prevents you from fastening the buckles on the rucksack.

>actions
Actions listing on.

>wear it
[wearing the leather rucksack]
A mystical force prevents you from fastening the buckles on the rucksack.
[wearing the leather rucksack - failed the Check wearing the rucksack during Everything Is Open]

* * *

>n
If you get any closer to the aerie without summoning mist first, the guards would surely see you.  It's why, as a Bostrat, you were originally chosen to go on this mission.

>summon mist
Calling on your heritage as a Bostrat, you summon moisture from the air, and it slowly coalesces into a creeping grey mist, obscuring you from sight.  In gentler times, you would be doing this to ensure the growth of the fields and forests; now you must use it to hide from prying eyes that would keep you from your quarry.

>n
Royal Landing Cradle
It's dangerous; you can't do anything here yet. LS DEBUG.  (you can go south, southeast, up)

>u
High Above the Royal Aerie
Your summoned mist both obscures you and blocks you from seeing the Royal Aerie.  But you've already memorized its layout, and how it relates to today's air currents, winds, and thermals.  Royal quarters to the north, well defended by circling Raven clan guards.  The librum to the east.  {LS DEBUG: a few other rooms.  Presumably.  Kitchen, Barracks, Chapel(?), }  In the center of the Aerie (and directly below you) is the Great Hall.

>e
Librum Landing Cradle
The Landing Cradle of the Librum is beautifully set with interlocking redwood and pine, suggesting shelves of books.  {Probably be more descriptive here LS DEBUG}.

To the west is the Great Hall, and to the northwest is the Royal Quarters.

You can see Another Important Door here.

>u
High Above the Royal Aerie
Your summoned mist both obscures you and blocks you from seeing the Royal Aerie.  But you've already memorized its layout, and how it relates to today's air currents, winds, and thermals.  Royal quarters to the north, well defended by circling Raven clan guards.  The librum to the east.  {LS DEBUG: a few other rooms.  Presumably.  Kitchen, Barracks, Chapel(?), }  In the center of the Aerie (and directly below you) is the Great Hall.

>w
You can't go that way.

>s
You can't go that way.

>d
Great Hall Landing Cradle
The Landing Cradle of the Great Hall spreads out over nearly a quarter of the vast building.  During your time here, you learned this was so that when a number of important guests and their retinues arrive at the same time, they can land simultaneously, instead of one after the other, which some would invariably take as meaning "in order of importance".

To the north is the Royal Quarters, the Librum to the east, {other places LS DEBUG}, and as always, you can return to the skies.

You can see an important door here.

>u
High Above the Royal Aerie
Your summoned mist both obscures you and blocks you from seeing the Royal Aerie.  But you've already memorized its layout, and how it relates to today's air currents, winds, and thermals.  Royal quarters to the north, well defended by circling Raven clan guards.  The librum to the east.  {LS DEBUG: a few other rooms.  Presumably.  Kitchen, Barracks, Chapel(?), }  In the center of the Aerie (and directly below you) is the Great Hall.

* * *

>open purple
You open the purple capsa of rezrov, revealing a scroll of rezrov.

As you open the purple capsa, an almost-palpable wave of force emanates from it, as the power of the revealed scroll of rezrov is released.
The magic of the gold capsa of FOO prevents it from being opened.
The magic of the red capsa of BAR prevents it from being opened.
The straps and buckles on your rucksack fly open and it falls!

The leather rucksack twists away as it falls below you, towards the Great Hall.

Also, you alert everyone to your presence, and they start heading straight for you.  Fortunately, they are, as of yet, unimplemented.  LS DEBUG.

>d
If you get any closer to the aerie without summoning mist first, the guards would surely see you.  It's why, as a Bostrat, you were originally chosen to go on this mission.

>summon mist
Calling on your heritage as a Bostrat, you summon moisture from the air, and it slowly coalesces into a creeping grey mist, obscuring you from sight.  In gentler times, you would be doing this to ensure the growth of the fields and forests; now you must use it to hide from prying eyes that would keep you from your quarry.

>d
You descend, bringing mist with you, and trusting your memorization of the air currents to tell you where you're going...

Great Hall Landing Cradle
The Landing Cradle of the Great Hall spreads out over nearly a quarter of the vast building.  During your time here, you learned this was so that when a number of important guests and their retinues arrive at the same time, they can land simultaneously, instead of one after the other, which some would invariably take as meaning "in order of importance".

To the north is the Royal Quarters, the Librum to the east, {other places LS DEBUG}, and as always, you can return to the skies.

You can see a leather rucksack (in which are a purple capsa of rezrov (in which is a scroll of rezrov), a gold capsa of FOO (closed), and a red capsa of BAR (closed)) and an important door here.

>get rucksack
Taken.

>open door
That's already open.

>close door
Try as you might, a mystical force prevents you from closing the important door.

>close rucksack
Try as you might, a mystical force prevents you from closing the leather rucksack.

* * *

>test summon
(Testing.)

>[1] d
If you get any closer to the aerie without summoning mist first, the guards would surely see you.  It's why, as a Bostrat, you were originally chosen to go on this mission.

>[2] n
You'll need to SUMMON MIST first, to cloak your descent.

>[3] summon mist
Calling on your heritage as a Bostrat, you summon moisture from the air, and it slowly coalesces into a creeping grey mist, obscuring you from sight.  In gentler times, you would be doing this to ensure the growth of the fields and forests; now you must use it to hide from prying eyes that would keep you from your quarry.

>[4] d

Great Hall Landing Cradle
The Landing Cradle of the Great Hall spreads out over nearly a quarter of the vast building.  During your time here, you learned this was so that when a number of important guests and their retinues arrive at the same time, they can land simultaneously, instead of one after the other, which some would invariably take as meaning "in order of importance".

To the north is the Royal Quarters, the Librum to the east, {other places LS DEBUG}, and as always, you can return to the skies.

You can see an important door here.

>[5] u

High Above the Royal Aerie
Your summoned mist both obscures you and blocks you from seeing the Royal Aerie.  But you've already memorized its layout, and how it relates to today's air currents, winds, and thermals.  Royal quarters to the north, well defended by circling Raven clan guards.  The librum to the east.  {LS DEBUG: a few other rooms.  Presumably.  Kitchen, Barracks, Chapel(?), }  In the center of the Aerie (and directly below you) is the Great Hall.

* * *

>x me
As good-looking as ever.  Up yours, Katsaris!

>#woot
I didn't understand that sentence.

># woot
Noted.

* * *

>x me.
As good-looking as ever.  Up yours, Katsaris!

* * *

>x mist
The cloud layer today is too high for a naturally obscuring mist; you'll have to summon it yourself.

>summon mist
Calling on your heritage as a Bostrat, you summon moisture from the air, and it slowly coalesces into a creeping grey mist, obscuring you from sight.  In gentler times, you would be doing this to ensure the growth of the fields and forests; now you must use it to hide from prying eyes that would keep you from your quarry.

>summon mist
You draw even more moisture from the air, feeding it into the mist.  It's still just as obscuring as before, but you feel safer, as you always do in the midst of clouds.

>x mist
Grey mist swirls and surrounds you, covering you like a blanket.

>i
You are carrying:
  a brown rucksack (being worn, and open)
    a purple capsa of rezrov (closed)
    a gold capsa of FOO (closed)
    a red capsa of BAR (closed)

>l
High Above the Royal Aerie
Your summoned mist both obscures you and blocks you from seeing the Royal Aerie.  But you've already memorized its layout, and how it relates to today's air currents, winds, and thermals.  Royal quarters to the north.  Well defended by circling Raven clan guards.  The librum to the east.

>x aerie
The Royal Aerie was grown and shaped by generations of Throckials, and now towers over the surrounding forest canopy.  Lush shades of browns and reds, often woven together in intricate patterns or pictures cover every landing cradle and wall.

>x purple
The purple capsa turned out to contain a scroll of rezrov, as became evident when every buckle and lock in your village flew open when you opened the capsa to investigate.  It is closed, preventing the power of the scroll from affecting the area.

>open purple
You open the purple capsa of rezrov, revealing a scroll of rezrov.

>x purple
The purple capsa turned out to contain a scroll of rezrov.  It is open, allowing the scroll's power to open and hold open any closed object in the area.

In the purple capsa of rezrov is a scroll of rezrov.

>x scroll
While "REZROV" can be clearly read at the top of the scroll, the rest is in some arcane script you (and the people and sages of your village) were unfamiliar with.

>x rezrov
(the scroll of rezrov)
While "REZROV" can be clearly read at the top of the scroll, the rest is in some arcane script you are unfamiliar with.

>close purple
You close the purple capsa of rezrov.

>x rezrov
The purple capsa turned out to contain a scroll of rezrov.  It is closed, preventing the power of the scroll from affecting the area.

>open purple
You open the purple capsa of rezrov, revealing a scroll of rezrov.

>get rezrov
(the scroll of rezrov)
Like all of the Ancient Scrolls, the scroll is inextricably tied to its capsa, and you can't extricate it.

>undo
High Above the Royal Aerie
[Previous turn undone.]

>get rezrov from purple
Like all of the Ancient Scrolls, the scroll is inextricably tied to its capsa, and you can't extricate it.

>eat rezrov
(the scroll of rezrov)
That's plainly inedible.

>drop rezrov
(the scroll of rezrov)
You haven't got that.

>put rezrov in rucksack
(the scroll of rezrov in the brown rucksack)
(first taking the scroll of rezrov)
Like all of the Ancient Scrolls, the scroll is inextricably tied to its capsa, and you can't extricate it.

>get rezrov from capsa
Which do you mean, the purple capsa of rezrov, the gold capsa of FOO, or the red capsa of BAR?

>purple
Like all of the Ancient Scrolls, the scroll is inextricably tied to its capsa, and you can't extricate it.

>i
You are carrying:
  a brown rucksack (being worn, and open)
    a purple capsa of rezrov (open)
      a scroll of rezrov
    a gold capsa of FOO (closed)
    a red capsa of BAR (closed)